Tease Me :: Chaka Demus & Pliers
Slow Hands :: Niall Horan
Talk of the Town :: Fred again.., Sammy Virji, Reggie
Bassline :: GEA
Paradise :: George Ezra
X-Rated :: Cloonee, Funkdoobiest
Soleil Bleu :: Bleu Soleil, Luiza
Burnin :: mischluft
BENDECIO :: PETERBLUE
Mystical Magical :: Benson Boone
Muschi Muschi :: DBBD, Miss Bashful
Cinnamon Girl :: Lana Del Rey
Paper Crown - Cricut :: Cricut
HARD TECHNO | Voices In My Head x Freaks x Love Parade (ACINA & BONKA Mashup) :: LOST IN RAVE - Channel
Jacques Your Body (Make Me Sweat) (Radio Edit) :: Les Rythmes Digitales
Blade :: D'Angello & Francis
SHOOT TO KILL :: t e s t p r e s s & Franck
I Like It Bad (Extended Mix) :: BEAUZ, Ceres
Fitness :: Odymel, HARD CANDY, TOXIMAMI, DJ Cringey
Rebotar (Extended Mix) :: David Löhlein, Eliangel
Vielä1 :: Vesta
SISTEM ERROR :: GIØ
Labrinth - Love Is Complicated (The Angels Sing) :: Labrinth
Love Today :: MIKA
Ocho (BEAUZ & KEVU VIP) (Extended Mix) :: BEAUZ, Kevu
I Found :: Amber Run
Bruv Parade :: BIIANCO
White Rabbit :: Haley Reinhart
PONPONPON :: Kyary Pamyu Pamyu
No Broke Boys :: Disco Lines, Tinashe
That’s So True :: Gracie Abrams
Pipe Down :: Snakehips, DijahSB
Don't Call Me Baby (Mousse T. Remix) :: Madison Avenue
Wobble :: V.I.C.
Ma Tnsani (Yalla Habibi) :: Vanco, AYA
Don't Waste My Time (feat. Jens Kuross) :: Âme, Trikk
Wonderful Life :: Katie Melua
Fix You :: Tommee Profitt, Stanaj, Staarz
Dangerous :: Kid Enigma, Riton
Dior :: MK, Chrystal
The Creeps (Club Edit) :: Camille Jones, Fedde Le Grand
Love Me Not :: Ravyn Lenae
I Know You Want Me (Calle Ocho) :: Pitbull
Gimme That Bounce :: Vaszlavik, Adam Miller (H)
Freak Like Me (Radio Edit) (feat. Katy B & MNEK) :: Lee Walker, DJ Deeon
Nothing but Everything :: Jon and Roy
Victory Lap :: Fred again.., Skepta, PlaqueBoyMax
Shake It To The Max (FLY) :: MOLIY, Silent Addy
I Believe in a Thing Called Love :: The Darkness
Techno Sh :: OKAYVAL
You Can't Hurry Love :: The Supremes
All Rise :: Blue
Freezing :: Wild Rivers
Mama :: Elizabeth Nichols
Pretty Little Baby :: Connie Francis
Girl :: Destiny's Child
Field Of Daisies :: Brian Stiroh
Me and the Devil :: Soap&Skin
I Got A New One :: Elizabeth Nichols
Maneater :: Nelly Furtado
Move Ya Body (feat. Jabba) :: Nina Sky
Naughty Girl (feat. Lil' Flip) :: Beyoncé
If There's Any Justice :: Lemar
It's Not That Easy :: Lemar
50/50 :: Lemar
Let Me Love You :: Mario
Silence vs. Intro (Chris Watson Mashup) :: Chris Watson
Show Me Love :: WizTheMc, bees & honey
To Build A Home (feat. Patrick Watson) :: The Cinematic Orchestra
Voice :: Vlinder Vos
Babycakes :: 3 Of A Kind
Written in the Stars (feat. Eric Turner) :: Tinie Tempah
Smack That (feat. Eminem) :: Akon
My Gasoline :: Maddix, Fēlēs
Black Eyed Peas - My Humps (BEAUZ Hard Techno Remix) :: BEAUZ, JKRS
Call Me Babe :: mischluft
FORZ4 :: t e s t p r e s s
The Muffin Song (feat. Amanda MacDonald) :: Sean Bertram
Save a Soul :: nimino
Tell Me It’s True :: Gorgon City
Dance All Night :: Vini Vici, Sonny Wern
Never Leave You (Uh Oooh, Uh Oooh) :: Lumidee
There's Another :: Bad Boombox
La Batteria (Extended Version) :: DJ Gigola
Angel Of My Dreams :: JADE
Schatten :: David Löhlein, MARA
Dior (Bonus) :: Pop Smoke
Soprano :: Nova Twins
Manchester :: Interplanetary Criminal
My Closed Room :: Artiom Goralsky
Lonely Alone (feat. Jeremy Zucker) :: Chelsea Cutler
The Piano & The Violin :: Polo & Pan
Anxiety :: Doechii
4am In A Rave (feat. rhys from the sticks) :: Hannah Laing
La Playa (feat. Sofia) :: Rove Ranger, David Löhlein
No Sleep (001) :: Van Damn
A Gira :: unfazed
Big Jet Plane :: Julia Stone, Angus
Hit 'Em Up Style (Oops!) :: Blu Cantrell
Messy (Sped Up) :: Lola Young
Jacob's Prayer :: Emile Mosseri
The Launch (UK Radio Edit) :: DJ Jean
Deep End (Extended Mix) :: John Summit
Lights Are On :: Atlantic Lights
Never see me again Orchestral Cover :: Galaxi
Somewhere Over The Rainbow - Judy Garland (piano cover) :: Katherine Cordova
Poppin' :: Hannah Laing
Nasty :: Tinashe
Twilight in Tankwa :: Be Svendsen
Kisses (feat. bbyclose) :: BL3SS, CamrinWatsin
Bass Boys :: Hannah Laing
Haven't Met You Yet :: Michael Bublé
Dreamin (feat. Daya) :: Dom Dolla
We Like The House :: KC
Paper Planes :: Voluptuöus
Monster :: The Automatic
Angel (Club Mix) :: Ralph Fridge
Loss of want back there :: The Caretaker
Baiana (Club Mix) :: Matt Sassari, CHRSTPHR, Barbatuques
Atomic Dislexia :: Prosper, Mad Rey
(They Long To Be) Close To You :: Carpenters
Naive :: The Kooks
Lick Ma :: Manu Medina
Find My Way Home :: Sammy Virji
Past Lives (Instrumental) :: Martin Arteta, creamy
Beautiful Things :: Benson Boone
Good Luck, Babe! :: Chappell Roan
Sinulog Theme Song | One Beat One Dance One Vision :: Chan Ababa
Give You the World :: Marc Broussard
Tiki Tiki (Extended Mix) :: Dario Nuñez, Javi Colina
Look Up Child :: Lauren Daigle
SeeSaw (feat. Romy) :: Jamie xx
JOY (Back On 74) :: Jungle, Joy Anonymous
Carry On :: Norah Jones
White Winter Hymnal :: Jesca Hoop
Feet Don't Fail Me Now :: Joy Crookes
Rainbow :: ATRIP
I See Colors :: Disco Lines, Rain Radio
Friday I'm In Love :: The Cure
Stars And Moons :: Dizzy
Coffee :: Sylvan Esso
Half The World Away :: Oasis
Hot Tea :: half·alive
Gold Rays :: Summer Kennedy
Origin Of Love :: MIKA
Back to Front :: Eliza Doolittle
The Call :: Regina Spektor
We're Going to Be Friends :: The White Stripes
Bonkers :: 9OASES
The Girl From Ipanema :: Stan Getz
Feel Stressed :: Longo, Marco Lollis
Talk :: Coldplay
Moon (And It Went Like) :: Kid Francescoli, Julia Minkin
White Noise (feat. AlunaGeorge) :: Disclosure
I Only Smoke When I Drink :: nimino
Hostage :: PLÜM
Danielle (smile on my face) :: Fred again..
Hot In Herre :: Nelly
Let Me Blow Ya Mind (feat. Gwen Stefani) :: Eve
Papi (Bhabi) :: Eden Shalev
The Rest Is Noise :: Jamie xx
Dafodil (feat. Kelsey Lu, John Glacier & Panda Bear) :: Jamie xx
BedRock (feat. Lloyd) :: Young Money
Signs (feat. Charlie Wilson & Justin Timberlake) :: Snoop Dogg
Medley: Let Me Talk to You / My Love (feat. T.I.) :: Justin Timberlake
Protector :: Tourist
flight fm :: Joy Orbison
Like Wooh Wooh :: Rnbstylerz
Obvs :: Jamie xx
Catching Eyes :: 49th & Main
Still Riding :: Barry Can’t Swim
Vhs :: Swimming Paul
Fading :: Swimming Paul
weightless :: Nosi
Bang :: Biscits
Nothing Perfect :: nimino
Moderat - More Love (Rampa &ME Remix) :: keinemusik
The Feeling I Get From You :: Jamie xx
She Said :: Plan B
Breather :: Jamie xx
TRIPPIN :: BUNT., Mapei
Runaway (feat. Pusha T) :: Kanye West
Travis Scott - FE!N (DJ TEDDY-O Afro House Remix) (feat. Playboi Carti) :: Travis Scott
flex fm (freddit) feat. Future, Lil Yachty, Playboi Carti (feat. Lil Yachty, Future & Playboi Carti) :: Joy Orbison
In My Dreams :: Four Tet, Ellie Goulding
Strange (Edit) :: Celeste
Black Friday (pretty like the sun) :: Lost Frequencies, Tom Odell
Clouds :: BUNT., Nate Traveller
Water (feat. Clara La San) :: Bicep
Body Move :: TEED
Apocalypse :: Cigarettes After Sex
Falling Together (feat. Oona Doherty) :: Jamie xx
Dancing Thing :: VisionV
Dreams :: Jaguar Dreams
Long Way 2 Go :: Cassie
The Cave :: Mumford & Sons
Sonnentanz - Sun Don't Shine (Sped-Up) (feat. Will Heard) :: Klangkarussell
Me & U :: Cassie
Fuck The Pain Away :: Hannah Laing, Peaches
Sunsleeper :: Barry Can’t Swim
Deadbeat Gospel (feat. somedeadbeat) :: Barry Can’t Swim, somedeadbeat
Lose Yourself :: Eminem
Mockingbird :: Eminem
Dirty Harry (feat. Bootie Brown) :: Gorillaz
Roses :: Outkast
I Glued My Balls To My Butthole Again :: Obscurest Vinyl
I Want Candy :: Aaron Carter
Flim :: Aphex Twin
Affirmation Practice :: DJ Gigola
My Barn My Rules :: MCR-T, horsegiirL
Money On My Mind :: Sam Smith
Famax (Edit) :: RAFFA GUIDO
Les Gout :: Rampa, Chuala, Keinemusik
I Got Summer On My Mind :: Jay Dunham
I Will Wait :: Mumford & Sons
My Little White Pony :: MCR-T, horsegiirL
King of My Castle (Roy Malone's King Radio Edit) :: Wamdue Project
Boyz N Da Club (Radio Edit) :: Shermanology
Little Lion Man :: Mumford & Sons
Move :: Adam Port, Stryv, Keinemusik, Orso
Space Cave :: Vlinder Vos
Stream State :: DJ Gigola
Sueño :: DJ Gigola, Kev Koko
California Dreamin' (Single Version) :: The Mamas & The Papas
Hotel California :: Eagles
Amazing Horse :: Mr Weebl
Relax My Eyes :: ANOTR, Abel Balder
Gratitude Practice :: DJ Gigola
Take Me Home, Country Roads :: John Denver
Midnight Gospel :: Zak Abel
Big Iron :: Marty Robbins
House of the Rising Sun :: The Animals
Paint It, Black :: The Rolling Stones
In Hell I'll Be in Good Company :: The Dead South
Jolene :: Dolly Parton
Brown Eyed Girl :: Van Morrison
Ring of Fire :: Johnny Cash
Folsom Prison Blues :: Johnny Cash
Return to Sender (From "Girls! Girls! Girls!") :: Elvis Presley
Oogum Boogum Song :: Brenton Wood
Wicked Games [Radio Edit] (feat. Anna Naklab) :: Parra for Cuva
Numb (Elderbrook VIP) :: Elderbrook
New Generation :: Layton Giordani
Dream Catch Me :: Newton Faulkner
Pompeii :: Bastille
places to be :: Fred again.., Anderson .Paak, CHIKA
The Thrill :: Wiz Khalifa, Empire Of The Sun
Many Men (Wish Death) :: 50 Cent
Money Trees (feat. Jay Rock) :: Kendrick Lamar
Those Nights :: Bastille
Bebé :: Sloujin
Ritmo :: Raffa FL
Heaven Knows I'm Miserable Now (2008 Remaster) :: The Smiths
Quarter Past Midnight :: Bastille
Jungle (Rico Nasty Remix) :: Fred again..
Fake ID x Gecko (Mashup) :: DaDa
Outside Rave :: Jens Lissat
Different Side :: Michael Bibi, Kinahau, Audio Bullys
Midnight (The Hanging Tree) (feat. Jalja) :: HOSH, 1979
Music Sounds Better With You x Fake ID :: J-Key
Ian Asher - Calabria x Cha Cha (Lyrics) [Extended] :: WE ARE BLACK&WHITE
PICK UP THE PHONE (Extended) (feat. Nate Dogg) :: PAWSA
What You Waiting For? :: Gwen Stefani
Techno Poem :: Patrik Berg
Innadadance (Meduza Remix Edit) (feat. Suli Breaks & Jazzie B) :: Faithless
The Sound of K :: Ballarak
Roar :: Charlotte de Witte
Would You (go to bed with me?) :: Campbell, Alcemist
Give It To Me :: Kormak
Finder :: Ninetoes
The Chant :: Duke Dumont
Bellissima (Radio Mix) :: DJ Quicksilver
Feel Stressed (Extended Mix) :: Longo, Marco Lollis
Talking :: Elderbrook
Guddi Riddim (feat. Nooran Sisters) :: DJ Snake, Wade
Now We Are Free (from “Gladiator”) (Piano Version) :: Jacob's Piano
I Like The Way :: David Löhlein, Rove Ranger
She’s Gone, Dance On :: Disclosure
MAMI :: Chris Lorenzo, COBRAH
Glue Time :: tanitah26
sure thing - Miguel (Wiskim Remix) slowed, pitched, tik tok version :: gledits 
girl$ :: Dom Dolla
Too Sweet :: Hozier
Express Yourself (Mochakk Remix) (feat. Nicky Da B) :: Diplo
Low :: Black V Neck, JKATZ
Travis Scott - Hell of a night (Beginning repeated) :: from Paris
Travis Scott - Hell Of A Night :: Lloyd Ellis
The Long Way Home :: Norah Jones
Rise :: Gabrielle
Back for Good (Radio Mix) :: Take That
Drop It Down :: Eli Brown, Joyhauser
Too Lost In You :: Sugababes
Too Little Too Late :: JoJo
All For You :: Janet Jackson
I'll Be There :: Jess Glynne
Memories :: Brendan Ross
Stop Time :: Walker & Royce, Glass Petals, Elohim
Green Velvet & Joeski - BARBEE :: Green Velvet
How Many Love Songs Have Died In Vegas? :: Swim Deep
Natural Blues :: Moby
Prok|Fitch x Green Velvet - Sheeple :: Green Velvet
All Night (Garage Version) (feat. Oscar and the Wolf) :: Maceo Plex
Cajmere - Percolator (Will Clarke Remix) :: Relief
Make Me Feel :: John Summit
Tataki :: Argy
Somebody (feat. Kimbra & Sante Sansone) :: Gotye, FISHER, Chris Lake
Taky Taky :: Eugenio Taicuz
Tataki (Remix) :: Eugenio Taicuz
Little Palace :: Rohaan
Counting (feat. Princess Superstar) :: Hamdi
Sweet Dreams :: Beyoncé
Isn't She Lovely :: UNDRESSD, Ellie May
Happy Pills :: Norah Jones
House All The Time :: Biscits
Get Get Down :: Paul Johnson
Better (feat. Jena) :: Ferreck Dawn
Back Tomorrow (Extended Mix) :: Ferreck Dawn, Jem Cooke
Talk To Me :: Two Shell, FKA Twigs
My Bassline :: Jon Void
Chase The Sun :: Koven
i hate edm :: Riot Ten
Rhyme Dust (Dimension Remix) :: MK, Dom Dolla
Isabella of Castile :: STRFKR
Dirrty (feat. Redman) :: Christina Aguilera
The Function :: Ship Wrek
Say Yes To Heaven :: Lana Del Rey
Your Mind Is Dirty :: Mau P
Change It :: TouchTalk
Who Are You? (Chris Lake Remix) :: Miane, Chris Lake
Jealous :: Mochakk
Allein :: Pryda
Super Bass :: Nicki Minaj
Starships :: Nicki Minaj
Techno Tree :: Will Clarke, Ammara
Tec No :: Will Clarke
Lil Boo Thang :: Paul Russell
Satisfy :: Max Styler
Douha (Mali Mali) (Edit) :: Disclosure, Fatoumata Diawara
Chromatic :: Anti Up
Saving Up :: Dom Dolla
Hit Em With It :: KILIMANJARO
Don't You Cry :: Sunday Scaries, Discrete
Ridin' Dirty :: Öwnboss, NXNJAS, Chamillionaire
Where You Are :: John Summit, HAYLA
Designs For You (Will Clarke Remix) :: Phantoms
One Pill :: VNSSA
Sun Came Up :: SOFI TUKKER, John Summit
Imagination (feat. Katy Menditta) :: Gorgon City
Rhythm Machine :: Westend, Max Styler
Baianá :: Bakermat
Shiver :: John Summit, HAYLA
Someday (salute Remix) :: DJ Seinfeld
We Are The People :: Empire Of The Sun
Holiday :: Confidence Man
Without Me :: Halsey
With Ur Love (feat. Mike Posner) :: Cher Lloyd
Wishin' and Hoping (Glee Cast Version) :: Glee Cast
Wish You Were Mine (Radio Edit) :: Philip George
i like the way you kiss me :: Artemas
Rigor :: Trikk
Trouble :: Cage The Elephant
Telugu Tech (Extended Mix) :: Wax Motif
Summertime in the City :: Scouting For Girls
Chill Like That (Odd Mob Remix) :: Sunday Scaries, PiCKUPLiNES
Ohm (Extended Mix) :: T78, MOTVS
Hate or Glory :: Gesaffelstein
Big Jumps :: Emilíana Torrini
Bump & Grind 2014 (Radio Edit) :: Waze & Odyssey, R.Kelly
Sex, Drugs, Alcohol :: Black V Neck
Pump the Brakes :: Dom Dolla
abcdefu :: GAYLE
Purple Hat :: SOFI TUKKER
Pain And Pleasure :: Black V Neck, Dipzy
Like Whoa :: Black V Neck
California Gurls (feat. Snoop Dogg) :: Katy Perry
If U Need It :: Sammy Virji
Strangers :: Kenya Grace
Swing :: SOFI TUKKER
Vogue :: Noizu
Stereo Love (Radio Edit) (feat. Vika Jigulina) :: Edward Maya
Flatline :: Hydraulix
Church of Nonsense :: Daniele Papini
Friends (feat. Reo Cragun) :: Flume
Drag Me Out :: Kah-Lo
Pills :: Will Sparks, ShortRound
I Go Out (2020 Rework) :: Deborah De Luca
The Age Of Love (Charlotte de Witte & Enrico Sangiuliano Remix) :: Age of Love
Your Song :: Elton John
Get Ready for This (Workout Mix) :: Power Music Workout
Can't Fight The Moonlight :: LeAnn Rimes
The Tide Is High (Radio Mix) :: Atomic Kitten
This Is A Song About Dancing :: Associanu
Tell Me Something Good :: Ewan McVicar
Do It To It (feat. Cherish) :: ACRAZE
What's It Gonna Be (Agent X Re-Rub Edit) (feat. Platnum) :: H "Two" O
Alright :: Supergrass
I Predict A Riot :: Kaiser Chiefs
Only Human :: KH
home :: Two Shell
Shiko :: Gehlektek, TakaTuka
LSD :: Will Sparks, New World Sound
Bring It Back :: Will Sparks, Joel Fletcher
Switch Back :: Quintino
Half The World Away :: Oasis
No Goodbye (Extended Version) :: Paul Kalkbrenner
On My Knees :: RÜFÜS DU SOL
Bocat :: Albertina, Guy Gerber
You Give Me A Feeling :: Vintage Culture, James Hype
Cut Me Loose (feat. Max Marshall) :: Jethro Heston, Cardboard Foxes
Mi Amor :: Cloonee, Wade
Wild West :: Pickle
So U Kno :: Overmono
Running Up That Hill (A Deal With God) :: Kate Bush
Inner Smile :: Texas
Minimal :: Deborah De Luca
Dancing :: James Hype
We Can Dance Again (Extended Mix) :: Armin van Buuren, Reinier Zonneveld, Roland Clark
Ah Yeah So What (WAYF Edit) (feat. Wiley & Elen Levon) :: Will Sparks
Looking at Your Pager (Extended) :: KH
Desire :: MEG MYERS
Love Me For The Weekend (feat. Ashe) :: MAX, Party Pupils
Magic In The Hamptons (feat. Lil Yachty) :: Social House
Move Your Body :: Marshall Jefferson, Solardo
It's A Killa (Shermanology Edit) :: Fisher (OZ)
Shadowax - A & B (Version) [RASSVET003] :: cobra cobra
When A Fire Starts To Burn :: Disclosure
Lilly Winwood and Steve Winwood - Higher Love (The Umbrella Academy 3 Soundtrack) :: The Umbrella Academy
Smile (Mono / 1954 Version / Remastered 1992) :: Nat King Cole
Dreams :: The Cranberries
As I Lay Me Down :: Sophie B. Hawkins
I Love You Always Forever (Edit) :: Donna Lewis
Make Her Say (feat. Kanye West & Common) :: Kid Cudi
Wallflower :: Whethan
A Better Son/Daughter :: Rilo Kiley
N35 :: ghostShell
Two Shell - [round] :: BlueDollarBillz
Yes We Can Obama Song by will.i.am :: will.i.am
Frontier Psychiatrist :: The Avalanches
Heartbreak :: Bonobo, TEED
Back to Basics (Floating Points Remix) (feat. Skepta) :: Headie One
18HUNNA (Four Tet Remix) (feat. Dave) :: Headie One
Herds :: Mattheis
Daydreamer [Extended Mix] (feat. Leo Stannard) :: KC Lights
Dirty Love (feat. Talay Riley) :: Wilkinson
Honey (Edit) :: Eats Everything
Ecstasy (Over & Over) :: Prospa
Let It Go (Dom Dolla Remix) (feat. Marc E. Bassy) :: Louie Vega, The Martinez Brothers
Fur :: Endor
Suerte :: Raffa FL
More Life (feat. Tinie Tempah & L Devine) :: Torren Foot
John Summit - Deep End :: Selected.
When We Were Young :: Adele
Liability :: Lorde
Perfect :: Ed Sheeran
The Dickhead Song :: Miles Betterman
Hard to Be Her :: Fisher
Adages :: Fisher
Teardrop (feat. Elizabeth Fraser) :: Massive Attack
Porcelain :: Moby
I Like That :: Bazzi
Chicago :: Sufjan Stevens
SKYBOX :: Gunna
Paranoid :: Emily Warren
Light :: San Holo
People In The Middle :: Chapter & Verse
Dancing Cliché :: LF SYSTEM
Afraid To Feel :: LF SYSTEM
Hagop Tchaparian - GL / Raining [2022] :: scrobbles by DJ GUNBOUND
The Weekend (Radio Edit) :: Michael Gray
Some Minds :: Flume, Andrew Wyatt
Jungle (Extended) :: Fred again..
I Like The Way (Full Length Version) :: Bodyrockers
Boogie 2Nite (Seamus Haji Big Love Club Mix) :: Booty Luv
Turn On The Lights again.. (feat. Future) :: Fred again.., Swedish House Mafia
Come Home (Edit Radio) :: Yael Naim
B.O.T.A. (Baddest Of Them All) :: Eliza Rose, Interplanetary Criminal
Language (Walker & Royce Remix) :: Mindchatter
Just A Ride :: Jem
Believe :: Eli Brown
Time to Burn (12" Long Version) :: Storm
All For You :: Cian Ducrot, Ella Henderson
Nothing's Real but Love :: Rebecca Ferguson
Our Day Will Come :: Amy Winehouse
World's Smallest Violin :: AJR
WHAT :: Rnbstylerz, AREES
Drugs From Amsterdam :: Mau P
Circles :: Machineheart, Vanic
Reverse the Bass :: TNT, Technoboy, Tuneboy
You Don't Know Me :: Jann Arden
No Other Love :: Jo Stafford
The Way You Look Tonight :: Tony Bennett
What The World Needs Now :: Dionne Warwick
Love Yourself (Short Reprise) :: Sufjan Stevens
In My Blood :: Vitamin String Quartet
With My Whole Heart :: Sufjan Stevens
Mystery of Love :: Sufjan Stevens
Rich Youth :: Hayley Kiyoko
The One :: Kodaline
Super Freaky Girl :: Nicki Minaj
Requiem :: Polo & Pan
Unwritten :: Natasha Bedingfield
Angels (XXV) :: Robbie Williams
Ae Dil :: Shiraz Uppal & Junita Gandhi
Vigil :: Golden Features
Satin PSICODELIC :: Sunni Colón
I Drink Wine :: Adele
Ready To Fly (Sub Focus & Dimension) :: Sub Focus, Dimension
Big City Life :: Luude, Mattafix
Free Tibet (Vini Vici Remix) :: Hilight Tribe
Nine Million Bicycles :: Katie Melua
Rollerblades :: Eliza Doolittle
Beat Goes On (Rhythm to the Brain) :: Campbell
Moneybox :: Eliza Doolittle
Nobody :: Eliza Doolittle
Block me out :: Gracie Abrams
All I Wanna Do :: Sheryl Crow
Anti-Hero :: Taylor Swift
A$AP ROCKY - Praise the Lord (DURDENHAUER Remix) - Patrick Topping , trym :: Grant G
Brooklyn In The Summer :: Aloe Blacc
Welcome To London :: Charlie Sparks (UK)
La vie en rose :: Édith Piaf
The Sounds of Silence :: Simon & Garfunkel
Amazing Grace :: Judy Collins
Make You Happy :: MIKA
Your Song (Bonus Track) :: Ellie Goulding
Mysterium :: Hammock
We're Going To Be Friends :: The White Stripes
Rumble :: Skrillex, Fred again.., Flowdan
Never Forget You :: Noisettes
Gold Rays :: Summer Kennedy
Someone New :: Hozier
Enormous Penis :: Da Vinci's Notebook
Does Your Mother Know :: ABBA
Super Trouper :: ABBA
Supersonic (my existence) :: Skrillex, Noisia, josh pan, Dylan Brady
Work It (feat. DJ Deeon) :: Dance System
My Heart Goes Boom (La Di Da Da) (Xtended Club Version / Reloaded) :: French Affair
LET'S DO IT AGAIN :: Jamie xx
Fabulous Secret Powers :: slackcircus
messy in heaven :: venbee, goddard.
pinkpantheress - Just For Me (salute Edit) :: BlueDollarBillz
Now Let Me See You Work (feat. Elle Zed) :: Joe Brunning
Tous les mêmes :: Stromae
Up & Down :: Vengaboys
Like A Star :: Corinne Bailey Rae
Agitations tropicales :: L'Impératrice
Green Green Grass :: George Ezra
Unholy :: Sam Smith, Kim Petras
Love Tonight :: Shouse
Bel Mercy :: Jengi
Three Little Birds :: Bob Marley & The Wailers
Ameno :: ERA
Another Love :: Tom Odell
Birthday Song :: Frankie Cosmos
Consciousness :: Anyma, Chris Avantgarde
Oracle :: Timmy Trumpet
The Bad Touch :: Bloodhound Gang
J Balvin, Skrillex - In Da Getto (Andrew Lux Remix) :: ANDREW LUX
Chicago - Street Player (Andrew Lux Remix) :: ANDREW LUX
ABBA - Gimme! Gimme! Gimme! (A Man After Midnight)(HÄWK VIP Edit) :: HÄWK
Je l'ai vu [Bouyon Kings Mixtape] (feat. Arendi) :: HollyG
Cœur croisé :: Polo & Pan
Sammy Virji - Never Let You Go :: DEEPROT
Caramelldansen (Speedy Mixes) :: Caramella Girls
À nos souvenirs :: Trois Cafés Gourmands
I Luv Women :: Mr Traumatik
Lets get naughty :: Mr Traumatik
Listen :: Alan Watts, Boreta
Happy Together :: Pomplamoose
How to disappear :: Lana Del Rey
Unholy (Disclosure Remix) :: Sam Smith, Kim Petras
Linda :: Tokischa, ROSALÍA
Bande organisée :: Kofs, JUL, Naps, Houari
Kammy (like i do) :: Fred again..
Heaven (feat. Do) :: DJ Sammy
The Boys of Summer :: DJ Sammy
Omen (Extended) :: The Prodigy
Firestarter :: The Prodigy
May It Be :: Enya
Baby again.. :: Fred again.., Skrillex, Four Tet
Blawan - Why They Hide Their Bodies Under My Garage [Hinge Finger] :: the29novTHEATER
Supalonely (feat. Gus Dapperton) :: BENEE
Calm Down :: Rema
Hurricane (Arty Remix) :: Halsey
Gradur ft Heuss L'enfoiré - Ne reviens pas (YANISS Official Remix) :: YANISS MUSIC
bda creature (feat. Blue Dust Archive) :: altrice
COUNTRY RIDDIM :: HOL!
Say You Love Me :: Jessie Ware
Gifted :: Cristobal Tapia De Veer
Spirits :: The Strumbellas
Dolce Vita :: La Cantina
I Think I Like It (Radio Edit) :: Fake Blood
Hello Hello Hello (Polo & Pan Remix) :: Remi Wolf
That's What's Up :: Lennon and Maisy
Ante Up (Robbin Hoodz Theory) :: M.O.P.
Linda :: Tokischa, ROSALÍA
In Da Getto (Chris Lorenzo Remix) :: J. Balvin, Skrillex
Adrenaline Rush (feat. MORGAN) :: Sigma
Sweet Baby (feat. Cody Francis) :: Bothnia
Little Fun :: Kata
INDUSTRY BABY :: Lil Nas X, Jack Harlow
Anaconda :: Nicki Minaj
Chromatic :: Anti Up
Bittersweet Goodbye :: Issey Cross
The Night We Met :: Lord Huron
I Always Knew :: The Vaccines
Uhn Tiss Uhn Tiss Uhn Tiss :: Bloodhound Gang
Joy Orbison - Big Room Tech House Dj Tool - TIP! (Full HQ) :: Rem Green
Fine Day Anthem :: Skrillex, Boys Noize, Opus III
Pulaski at Night :: Andrew Bird
Rock DJ :: Robbie Williams
Work (Radio Edit) :: Masters At Work
Doja :: Central Cee
The Show :: Lenka
Beat Trava Pulmão :: Mc Menor Do Alvorada, Mc Gw, dj caxa da zl
Pepas (Tiësto Remix) :: Farruko, Tiësto
Good Love :: Hannah Laing, RoRo
Archangel :: Burial
(It Goes Like) Nanana (Edit) :: Peggy Gou
Off Wiv Ya Headz :: Nia Archives
KILL DEM :: Jamie xx
Born Slippy (Nuxx) (Radio Edit) :: Underworld
The Night We Met (feat. Justin Beaulieu) :: Marianne Beaulieu
Push Up (Short Version) :: Creeds
Push To Start :: Noizu, Westend, No/Me
Grey :: Kölsch
Dance For Me (1, 2, 3) (Stutter Techno) :: Sonny Wern, Lyente, Quinten Circle, ZANA
Can't Help Falling In Love (Instrumental - Lullaby Version) :: The Night Owl
Turning It Up (Ben Miller Extended Remix) (feat. Dope Earth Alien) :: Go Freek
Sunshine (My Girl) (Extended Mix) :: Wuki
Jump Around :: House Of Pain
Sarà perché ti amo :: Ricchi E Poveri
DNA (Loving You) (feat. Hannah Boleyn) :: Billy Gillies
Soul Mass Transit System - It Wasnt Me (Extended) :: Callumpugh07
Heads High :: Mr. Vegas
Baddadan (feat. IRAH, Flowdan, Trigga & Takura) :: Chase & Status, Bou
Be The One :: Eli Brown
JOY (In Me All The Time) :: Joy Anonymous
Diamonds On My Mind :: Eli Brown
Vibez :: Xvnty
A-Punk :: Vampire Weekend
Brimful of Asha (Norman Cook Remix Single Version) :: Cornershop
Disconnect :: Becky Hill, Chase & Status
Rhinestone Eyes :: Gorillaz
Awoo (feat. Betta Lemme) :: SOFI TUKKER
Your Woman :: White Town
Addicted To Bass (Apollo 440 Mix) :: Puretone
Buss The Red :: P Money, Whiney
Liquor & Cigarettes (feat. ArrDee) :: Chase & Status, Hedex
Filthy / Gorgeous :: Scissor Sisters
Adagio For Strings (feat. Tiësto) :: Push
Ray Of Solar :: Swedish House Mafia
What Was I Made For? [From The Motion Picture "Barbie"] :: Billie Eilish
Blow Out :: Overmono
In Manhattan :: Nation of Language
make me feel like :: SP4CKS
YOUNG FOLKS (TECHNO) :: BASSTON, Techno Tazzy, Tazzy
Body Moves :: AKUL
Nirvana :: Alan watts
Burn Dem Bridges (Extended Mix) :: Skin On Skin
Vois sur ton chemin (Techno Mix) :: BENNETT
Lights On (Single Mix) (feat. Ms Dynamite) :: Katy B
(Mucho Mambo) Sway (Radio Edit) :: Shaft
Like a Prayer (Radio Edit) :: Mad'House
Baddest Ruffest :: Backyard Dog
I'm A Believer :: Smash Mouth
Ain't No Rest For The Wicked :: Cage The Elephant
Now We Are Free :: Lisa Gerrard, Gavin Greenaway, The Lyndhurst Orchestra
WAKA WAKA DRILL SPED UP :: DRILL GATES
Doja :: Central Cee
ADD SUV (feat. Pharrell Williams) (Armand Van Helden Vocal Remix) (feat. Pharrell Williams) :: Uffie
Carmina Burana: O Fortuna :: Michael Tilson Thomas, Carl Orff, Cleveland Orchestra Chorus
Fuck It (I Don't Want You Back) :: Eamon
F.U.R.B. (F U Right Back) :: Frankee
Mambo Italiano (Radio Edit) :: Shaft
You & Me Song :: Joy Crookes
Until I Found You :: Stephen Sanchez
Stardust (feat. Chiara) :: MIKA
Prada :: Cassö, RAYE, D-Block Europe
Sh-Boom :: The Chords
Heater (Radio Edit) :: Samim
Love Island :: Fatboy Slim
Dandelions :: Ruth B.
All Under One Roof Raving :: Jamie xx
Kiss Me Thru The Phone (feat. Sammie) :: Soulja Boy Tell'em
Renaissance (The White Lotus) [Tiësto Remix] :: Tiësto, Cristobal Tapia De Veer
Bad Reputation :: Joan Jett
Anthem Academy - Good Life :: IndieAir
Alive :: Daft Punk
AROUND THE WORLD (LA LA LA LA LA) - (TECHNO) :: BASSTON, STRØBE, Tazzy
Instant Crush (feat. Julian Casablancas) :: Daft Punk, Julian Casablancas
This Isn’t The End :: Owl City
I'll Be Around (Club Mix) (feat. Timbaland) :: Cee-Lo
Loss of want back there :: The Caretaker
MANTRAS IN SUNILDA'S SAVITRI MUSIC BOOK 05 CANTO 03 :: SRI AUROBINDO SAVITRI
For the Damaged Coda :: Blonde Redhead
Orinoco Flow (Sail Away) [Single Version] :: Enya
Only Human (Extended) :: KH
KETTAMA - THE VERVE :: Moskalus
Shpongle - Museum of Consciousness [FULL ALBUM] :: Shpongle
M79 :: Vampire Weekend
It's So Good :: Jamie xx
Einaudi: Experience :: Ludovico Einaudi, Daniel Hope, I Virtuosi Italiani
death bed (coffee for your head) :: Powfu, beabadoobee
Going So Low :: Daniel Avery
California soul (A.Skillz Remix) :: Marek
Warrior's Dance (Edit) :: The Prodigy
Dream A Little Dream Of Me :: The Mamas & The Papas
Dancing On My Own :: Robyn
My Way (2008 Remastered) :: Frank Sinatra
Put Your Head On My Shoulder :: Paul Anka
Come Together (feat. Tyson Kelly) :: Urbandawn
I Can Do Anything / Finale :: Christopher Lennertz
I Was Made For Lovin' You :: Kiss
Big Girl (You Are Beautiful) :: MIKA
Fire (feat. Ms Dynamite) :: Magnetic Man
Con Te Partirò :: Andrea Bocelli
Saturday Night (Nite Mix) :: Whigfield
Saturday Night (Radio Edit) :: Whigfield
You & I (feat. Cari Golden) :: Fur Coat
Sunshine (My Girl) (Sofi Tukker Remix) :: Wuki, Sofi Tukker
No Reason (Chris Lake Remix) :: The Chemical Brothers
Turn Me Deeper [Extended Mix] (feat. Kathy Brown) :: Wh0, Mark Knight, James Hurr
Chapati :: UnderCover
Tidal Wave (feat. Alpines) :: Sub Focus
I Like The Way This Is Going :: EELS
Family Affair :: Mary J. Blige
Rhyme Dust (Extended) :: MK, Dom Dolla
Sprinter :: Dave, Central Cee
If I Can't :: 50 Cent
Bicep vs Rui Da Silva - Touch My Glue (@Djjaycarpenter Mashup) :: DJ Jay Carpenter
Daddy AF :: Slayyyter
Do It Like Me (Icy Feet) (feat. Sage The Gemini & Kelis) :: TCTS
Truisms 4 Dummies :: Headache
The Sky Was Pink (Holden Remix) :: Nathan Fake
Quiver :: SILK
Dance With You Tonight :: Laufey
Speed Trials On Acid (LF SYSTEM Remix) (feat. Dan Diamond) :: Carl Cox, Fatboy Slim
My Little Island :: Lyn Lapid
Carl Cox - wait for the drop video remake :: #SHARA - Georgia On Track
Magic :: Polo & Pan
No Nein :: 1tbsp, Mietze Conte
The Power :: Duke Dumont, Zak Abel
Love Tonight (Robin Schulz Remix) :: Shouse
GMT (Jamie xx Remix) :: Oliver Sim, Jamie xx
I'm Tired (Bonus Track) :: Labrinth, Zendaya
F For You (feat. Mary J. Blige) :: Disclosure
Drop The Game :: Flume, Chet Faker
CHROMA 001 HELIUM :: Bicep
Velocity N20 :: Neuroticfish
Past Lives :: BØRNS
In Your Phase (feat. 22Carbone) :: Laurent Garnier
temporary nothing (revisited) :: mxmtoon
like you want me to :: Lyn Lapid
The 30th :: Billie Eilish
Jesus Walks :: Kanye West
Homecoming (feat. Chris Martin) :: Kanye West
The Look :: Metronomy
Moving All Around (Jumpin') (John Summit Remix) (feat. Kim English) :: Schak
Water :: Tyla
You Can Do It (feat. Mack 10) :: Ice Cube, Ms. Toi, Mack 10
Dance Wiv Me (Radio Edit) (feat. Calvin Harris & Chrome) :: Dizzee Rascal
Money :: Leikeli47
Beggin' :: Chris Lake, Aluna
Around (Solomun Vox) :: Noir, Haze
Dance To The Music (Extended Mix) :: Low Steppa, Tony Romera
People Help the People :: Birdy
dream of you :: mxmtoon
this is what losing someone feels like :: JVKE
Maybe Someday :: Tremelo
Lovin On Me :: Jack Harlow
Cutie :: Shanti Celeste
I Think Of Angels :: Cat Power
The Times They Are A-Changin' :: Bob Dylan
Black Coffee :: All Saints
Swerve :: Anthony Naples
Show Me Love (Radio Version) :: Robyn
Don't Speak :: No Doubt
Put Your Head On My Shoulder :: The Macarons Project
If I Could Ride a Bike :: Park Bird, Chevy
the alternative :: Lyn Lapid
It's Like That (feat. Jermaine Dupri & Fatman Scoop) :: Mariah Carey
Be Faithful (feat. The Crooklyn Clan) :: Fatman Scoop
When She Loved Me :: Lyn Lapid
Party Girl (Gonna Do) :: Ultra Naté, KIMMIC
Now U Do :: DJ Seinfeld, Confidence Man
You're The Only One :: Katie May
ATB vs Sigala - Don't Stop Sweet Loving (Jamie B & Nova Scotia Remix Bootleg) [Bass Boosted] :: Central Bass Boost
Roc Ya Body "Mic Check 1, 2" :: M.V.P.
So This Is Love (feat. ConTejas) :: Sneha
hey :: egg
Won't Forget You :: Jax Jones, D.O.D, Ina Wroldsen
The Party that Never Ends :: Headache
Dance With Ibiza :: Ugo Banchi
All Over My Body (feat. Superchumbo) :: Ben Sterling
Biggest Regret (Drumsheds Version) :: Gorgon City, Bbyafricka
How Deep Is Your Love :: The Bird And The Bee
Just Feels Tight :: FISHER
Ghosts :: Two Shell
Left Outside Alone :: Anastacia
Rapture :: Paluma
We Don't Care (The Sicilian Dub) :: Audio Bullys
Марш :: IC3PEAK
Shot You Down :: Audio Bullys, Nancy Sinatra
Flat Beat :: Mr. Oizo
Jenny from the Block (Track Masters Remix) (feat. Jadakiss & Styles P.) :: Jennifer Lopez
Ye :: Burna Boy
Whole (demo) :: Sody
Who'd Have Known :: Lily Allen
Who Knows :: BEGINNERS
White Rabbit (Full Epic Trailer Version) | The Matrix Resurrections Official Trailer Song Music :: The Wizard
Under Pressure (feat. David Bowie) :: Queen
Too Many Drugs :: Rigoberta Bandini
The World's Greatest :: R.Kelly
The Rising :: Angel Lover
The Fear :: Lily Allen
Frontier Psychiatrist :: The Avalanches
Take Me Back to Your House :: Basement Jaxx
Sweet Coffee (feat. Bassette) :: Mullally
Superstylin' :: Groove Armada
Still :: Seinabo Sey
DFCW (Extended Mix) :: Sosa UK
Kreatur der Nacht (feat. Isolation Berlin) :: Solomun
Solitude (Extended Mix) :: Alexa Harley & Hybrid Minds
Smile :: Lily Allen
SKYBOX :: Gunna
Save Your Tears (Remix) :: The Weeknd, Ariana Grande
San Frandisco :: Dom Dolla
Rumors (feat. Cardi B) :: Lizzo
Red Light Green Light (For Club Play Only, Pt. 6) (feat. Shaun Ross) :: Duke Dumont
Red Alert (Jaxx Radio Mix) :: Basement Jaxx
Ray Of Sun :: Sub Focus, Wilkinson, Pawws
Talk About :: Rain Radio, DJ Craig Gorman
Kid Cudi - Pursuit Of Happiness (Official Instrumental) :: Zød
Play That Funky Music :: Wild Cherry
Out of Time (feat. Zara Kershaw) :: Monrroe
Opus :: Eric Prydz
Opal :: Bicep
On the Low :: Burna Boy
jealousy, jealousy :: Olivia Rodrigo
ocean view :: hard life
Not Fair :: Lily Allen
No Turning Back :: Gui Boratto
My Universe :: Coldplay, BTS
My Beat (Extended Mix) :: KI Creighton
Muero De Amor :: La Bien Querida
Mad at Disney :: salem ilese
Lovefool :: The Cardigans
Love Parade (DJ Phish Remix) :: Da Hool
Los Jardines De Marzo :: La Bien Querida
Lies, Deception, And Fantasy :: Chris Lake, Lee Foss
Leave The Door Open :: Bruno Mars, Anderson .Paak, Silk Sonic
Leave Before You Love Me :: Marshmello, Jonas Brothers
LDN :: Lily Allen
Lacchesi & Mac Declos - Give It To Me (Nelly X-Rated Edit) :: Possession Techno
La Perla :: Sofia Kourtesis
Kung Fu Fighting :: Carl Douglas
Knock 'Em Out :: Lily Allen
Kiss Me More (feat. SZA) :: Doja Cat
Banana Splits (The Tra La La Song) [as heard in the movie Kick Ass] :: The Dickies
Just Tell People How You Feel :: Pretty Preachers Club
Julio Iglesias :: Rigoberta Bandini
cheap sunglasses :: John K
It Just Won't Do (Club Mix) (feat. Sam Obernik) :: Tim Deluxe
Inside My Head :: Noizu, Eli Brown
Insect Near Piha Beach :: Four Tet
Innerbloom :: RÜFÜS DU SOL
INFERNO :: Sub Urban, Bella Poarch
In Spain We Call It Soledad :: Rigoberta Bandini
In For The Kill (Skream's Let's Get Ravey Remix) :: La Roux
Iko Iko (My Bestie) (feat. Small Jam) :: Justin Wellington
Idontknow :: Jamie xx
I Wanna Do :: Chemical Surf, Dubdisko
i miss u :: Jax Jones, Au/Ra
Hypertrophy of Heart (Extended Mix) (feat. Hydrah) :: Enamour
Demons :: Hayley Kiyoko
GOOD TIME :: Niko Moon
Good Luck (feat. Lisa Kekaula) :: Basement Jaxx
good 4 u :: Olivia Rodrigo
Heat Waves :: Glass Animals
Fuentes de Ortiz :: Ed Maverick
Friday (Dopamine Re-Edit) (feat. Mufasa  & Hypeman) :: Riton, Nightcrawlers
Freak :: Doja Cat
Fly Away :: Tones And I
Ratio (Full Mix) :: Floating Points
Fiesta :: Rigoberta Bandini
Feel So Close x Roses x Summer x I Love It MASHUP :: Electronify
Fancy Like :: Walker Hayes
Opus (Four Tet Remix) :: Eric Prydz
Beat :: Endor
Drunk On A Plane :: Dierks Bentley
Drogba (Joanna) :: Afro B
Nobody Speak (feat. Run The Jewels) :: DJ Shadow
Dinamita :: La Bien Querida
Destination Calabria (Radio Edit) (feat. Crystal Waters) :: Alex Gaudino
deja vu :: Olivia Rodrigo
Day 1 ◑ :: HONNE
Dance :: Noizu
Concentrate :: Anti Up
Come into My World (Radio Edit) :: Kylie Minogue
Come Away With Me :: Norah Jones
Chaise Longue :: Wet Leg
By Your Side :: Sofia Kourtesis
Build a Bitch :: Bella Poarch
Break It Off :: PinkPantheress
Bicep x Nelly Furtado - Glue x Say It Right :: Selected.
Opal (Four Tet Remix) :: Bicep
Beautiful Life :: Gui Boratto
Baby Baby :: Noizu
Ateo :: C. Tangana, NATHY PELUSO
Right Now :: Anti Up, Chris Lake, Chris Lorenzo
Angel (feat. Rayvon) :: Shaggy
All Summer Long :: Kid Rock
Alfie :: Lily Allen
Ain't Shit :: Doja Cat
Against All Odds (Take A Look At Me Now) :: Phil Collins
AOK :: Tai Verdes
618 :: Gui Boratto
100% Pure Love :: Crystal Waters
22 :: Lily Allen
1 step forward, 3 steps back :: Olivia Rodrigo
Zadok the Priest :: Westminster Abbey Choir, Martin Neary, Georg Friedrich Händel, Martin Baker
You've Got The Love :: Florence + The Machine
You've Got a Friend in Me :: Randy Newman
You're My Best Friend :: Queen
You're Beautiful :: James Blunt
Your Mrs :: JAY1
Your Mind :: Adam Beyer & Bart Skils
Your Body (Cat Dealers Extended) (feat. Michael Marshall) :: Tom Novy
Young Dumb & Broke :: Khalid
Young Folks :: Peter Bjorn And John
Young Blood :: The Naked And Famous
Young And Beautiful :: Lana Del Rey
You Want Me (feat. Sadie Ama) :: Tom Zanetti
Shout :: The Isley Brothers
You Make It Real (Live From Air Studios, London, UK) :: James Morrison
You Know You Like It :: DJ Snake, AlunaGeorge
You Know My Name (From "Casino Royale" Soundtrack) :: Chris Cornell
You Give Me Something :: James Morrison
(You Drive Me) Crazy :: Britney Spears
You Don't Own Me (feat. G-Eazy) :: SAYGRACE
You Don't Know Me :: Jax Jones, RAYE
You Da One :: Rihanna
You Can Call Me Al :: Paul Simon
You Belong With Me :: Taylor Swift
You Are a Cunt :: Kat McSnatch
You & Me :: KC Lights
You and I :: Margaret Glaspy
You And I :: Ingrid Michaelson
You & Me (Flume Remix) (feat. Eliza Doolittle) :: Disclosure
Yes Sir, I Can Boogie :: Baccara
Yellow :: Coldplay
Yellow :: 20syl
Year 3000 :: Busted
Yeah! (feat. Lil Jon & Ludacris) :: Usher
Wuthering Heights :: Kate Bush
Upper West - Wouldn't It Be :: SwagyTracks
Worth It :: Fifth Harmony
Worship :: MAX
Work This Out :: High School Musical Cast, Disney
Work It (Soulwax Remix) :: Marie Davidson
Wonderwall :: Oasis
Wonderland :: Caravan Palace
Wonderland :: C-BooL
(What A) Wonderful World :: Sam Cooke
Wonderful World :: James Morrison
Wonderful :: Angel
Wonder Woman :: LION BABE
Wolves :: Selena Gomez, Marshmello
Wolf Bite :: Owl City
Woke :: Yoshi Flower
Wishery :: Pogo
wish you were gay :: Billie Eilish
Wings :: Little Mix
Wings :: Birdy
Windfall :: TheFatRat
Wildest Dreams :: Taylor Swift
Wildcard (feat. Feli Ferraro) :: Mickey Valen
Wild Thoughts (feat. Rihanna & Bryson Tiller) :: DJ Khaled
Wild Ones (feat. Sia) :: Flo Rida
Wild for the Night (feat. Skrillex & Birdy Nam Nam) :: A$AP Rocky
Wiggle (feat. Snoop Dogg) :: Jason Derulo
Wicked Wonderland :: Martin Tungevaag
Why'd You Only Call Me When You're High? :: Arctic Monkeys
Whoppa (feat. Farina & Sofia Reyes) :: Tinie Tempah
Who Let The Dogs Out :: Baha Men
White Walls (feat. Hollis & ScHoolboy Q) :: Macklemore & Ryan Lewis
White Sky :: Vampire Weekend
Eyes on Fire (Zeds Dead Remix) :: Blue Foundation, Zeds Dead
Zeds Dead - White Satin :: UKF Dubstep
White Boi (feat. Lao Ra) :: Dillon Francis
Whistle For The Choir :: The Fratellis
Whistle :: Flo Rida
Wherever You Will Go :: Charlene Soraia
Where Is The Love? :: The Black Eyed Peas
Where Is My Mind :: Maxence Cyrin
When You're Smiling :: Michael Bublé
when the party's over :: Billie Eilish
When The Beat Drops Out :: Marlon Roudette
When She Was Mine :: Lawson
When She Loved Me :: Sarah McLachlan
When I Was A Youngster :: Rizzle Kicks
When I Grow Up :: Confetti
Robin hood Vs Jurrasic 5 - Whats golden :: John Crick (Desca)
Whatever You Choose :: GANZ
Whatcha Say :: Jason Derulo
What You Know :: Two Door Cinema Club
What Makes You Beautiful :: One Direction
What I've Been Looking For :: Lucas Grabeel, Sharpay, Disney
What If I Go? (feat. Bonzai) :: Mura Masa
What I Like About You (feat. Theresa Rex) :: Jonas Blue
What Can You Do for Me (Radio Edit) :: Utah Saints, Drumsound, Bassline Smith
What A Wonderful World :: Louis Armstrong
What a Bam :: Guille Placencia, George Privatti
West Coast :: Lana Del Rey
Weekends!!! (feat. Sirah) :: Skrillex
Blackbear - Weak When Ur Around (P Buddy Remix) :: CloudKid
Weak :: AJR
We No Speak Americano :: Yolanda Be Cool, DCup
We Make It Bounce (feat. Major Lazer & Stylo G) :: Dillon Francis
We Like To Party! (The Vengabus) :: Vengaboys
Wuki & Benzi - We Like to Fuck that Shit :: BassYourSpeakers
We Like To Wuki :: Wuki, Vengaboys, Yo Majesty
We Are Your Friends (Justice Vs Simian) :: Justice, Simian
We Are Young (feat. Janelle Monáe) :: fun.
We Are Never Ever Getting Back Together :: Taylor Swift
We Are Golden :: MIKA
Wavy Riddim :: Vato Gonzalez
Wavin'  Flag :: K'NAAN
Watch Out For This (Bumaye) (feat. Busy Signal, The Flexican & FS Green) :: Major Lazer
Watch Me (Whip / Nae Nae) :: Silentó
Wasted (feat. Matthew Koma) :: Tiësto
Warm This Winter :: Gabriella Cilmi
Robin Schulz   Warm Minds (Lexer Remix Remastered) :: EnnCee
WAP (feat. Megan Thee Stallion) :: Cardi B
Wannabe :: Spice Girls
Wanna Go Dancin :: FISHER
WALMART YODELING KID (Bombs Away EDM Remix) :: Bein Music
Walking on Sunshine (25th Anniversary;2010 - Remaster) :: Katrina and the Waves
Walk Into The Sun (Radio Edit) :: Maverick Sabre
Wake Me up When September Ends :: Green Day
Waiting for You (feat. Joanna Jones) :: Unlike Pluto
Waiting For Love :: Avicii
Wait On Me :: Rixton
The Voice Within :: Christina Aguilera
Viva La Vida :: Coldplay
All I Really Need (feat. Kenzie May) :: Vindata
Vienna :: Billy Joel
Video Games :: Lana Del Rey
Velvet Elvis :: Alex Winston
Vegas Girl :: Conor Maynard
Vanilla Twilight :: Owl City
Vamos a la Playa :: Loona
Valerie (Version Revisited) (feat. Amy Winehouse) :: Mark Ronson
Utopia :: Goldfrapp
Use Somebody :: Kings Of Leon
Uptown Girl (Radio Edit) :: Westlife
Upside Down :: Jack Johnson
Unlimited Combinations :: Bassnectar
United State of Pop 2015 (50 Shades of Pop) :: DJ Earworm
DJ Earworm - United State of Pop 2009 (Blame It on the Pop) :: Dj Earworm
Unforgettable (feat. Swae Lee) :: French Montana
Underneath It All (feat. Lady Saw) :: No Doubt
Under The Sun :: Cheryl
Unattainable (Dwilly Remix) (feat. Dwilly) :: Fluencee, Lilianna Wilde
Ugly Heart :: G.R.L.
Ugly :: Bubba Sparxxx
U Got the Power :: Swiss Lips
U Can't Touch This :: M.C. Hammer
Emily Zeck - Two Cents (Ice Cream Song) :: MrSuicideSheep
Twilight :: Cover Drive
Turn Up The Speakers (Radio Edit) :: Afrojack, Martin Garrix
Turn Up the Music :: Chris Brown
Like A G6 (feat. The Cataracs & DEV) :: Far East Movement
Turn Up The Love (feat. Cover Drive) :: Far East Movement
Turn the Music Louder (Rumble) (Radio Edit) (feat. Tinie Tempah) :: KDA, Katy B
Turn Me On :: Kevin Lyttle
Trumpsta (Djuro Remix) :: Contiez, Treyy G
Trumpets :: Jason Derulo
Everytime We Touch :: Cascada
Truly Madly Deeply :: Savage Garden
Trouble Is a Friend :: Lenka
Trouble (feat. Jennifer Hudson) :: Iggy Azalea
Trndsttr (Lucian Remix) (feat. M. Maggie) :: Black Coast, Lucian, & M. Maggie
Tremor (Sensation 2014 Anthem) :: Dimitri Vegas, Like Mike, Martin Garrix
Treading Water :: Alex Clare
Trap Queen :: Fetty Wap
Trampoline (feat. 2 Chainz) :: Tinie Tempah
Trampoline :: SHAED
Traktor (feat. Temilaye) :: Wretch 32
Toxic :: Yael Naim
Tous Les Garcons Et Les Filles :: Françoise Hardy
Touch Me :: Rui Da Silva
Torn :: Natalie Imbruglia
Top Rank Skank :: Benny Page, Mr Williamz
Toothbrush :: DNCE
Too Many Man (feat. Boy Better Know) :: Wiley
Too Close :: Alex Clare
Tonight :: Daniel Blume
Tongue Tied :: GROUPLOVE
Tondo :: Disclosure, Eko Roosevelt
Tomorrow :: Alicia Morton
TOKYO DRIFT（FAST ＆ FURIOUS） (『ワイルドスピードX3 TOKYO DRIFT』より　) - Tokyo Drift (Fast & Furious) (From "The Fast And The Furious: Tokyo Drift" Soundtrack) :: Teriyaki Boyz
Toes :: Glass Animals
Toca toca (Radio Edit) :: Fly Project
Title :: Meghan Trainor
NyannersVA (reupload) - errrbody in the club gettin tipsy ;A; RIP SNOOP DOGG :: Lemon Video Archive
Tipsy (Club Mix) :: J-Kwon
Tip Toe (feat. French Montana) :: Jason Derulo
Tiimmy Turner :: Desiigner
Time to Pretend :: MGMT
Time of Our Lives :: Pitbull, Ne-Yo
Time & Space :: Captain Hook
Time :: Hans Zimmer
Timber :: Pitbull, Kesha
Tilted :: Christine and the Queens
Till the World Ends :: Britney Spears
Till I Collapse (feat. Eminem) :: Eminem
TiK ToK :: Kesha
Tight (feat. Madge) :: Kaskade
F-Block - Thurston's Little Ditty :: fblockisadj
Thunderclouds (feat. Sia, Diplo & Labrinth) :: LSD
Thunder :: Imagine Dragons
[Mashup] Thomas the Tank Engine x Childish Gambino - Thomas the Bonfire :: Marcus Skjelseth
This Time Tomorrow :: Trent Dabbs
This Is What Makes Us Girls :: Lana Del Rey
This Is The Last Time :: Keane
This Is How We Do It (feat. Audien) :: Party Pupils
This Is How We Do :: Katy Perry
This Girl (Kungs Vs. Cookin' On 3 Burners) (Kungs Vs. Cookin' On 3 Burners) :: Kungs, Cookin' On 3 Burners
This Ain't a Love Song :: Scouting For Girls
breaux II - third man :: CloudKid
Thinking out Loud :: Ed Sheeran
Thinking of Me :: Olly Murs
The Thing-Ummy-Bob :: Gracie Fields
They :: Jem
These Words :: Natasha Bedingfield
These Days (feat. Jess Glynne, Macklemore & Dan Caplen) :: Rudimental
There for You :: Martin Garrix, Troye Sivan
The Winds of Winter :: Ramin Djawadi
The Way You Move (feat. Sleepy Brown) :: Outkast
The Way I Am :: Ingrid Michaelson
The Wanderer :: Dion
The Trouble :: Pogo
The Traveling Song :: will.i.am
The Times They Are A-Changin' :: Fort Nowhere
Hollaback Girl :: Gwen Stefani
The Sweet Escape (feat. Akon) :: Gwen Stefani
MUSIC: Jaguar Skills 'The Step Drum Dub Bass Mix' :: DRGNZ
The Scientist :: Coldplay
Rockafeller Skank :: Fatboy Slim
The Riddle (Radio Edit Mix) :: Prezioso, Marvin, & Marvin & Andrea Prezioso
The Riddle :: Gigi D'agostino
The Real Slim Shady :: Eminem
The Nosebleed Section :: Hilltop Hoods
The Nights :: Avicii
The Night King :: Ramin Djawadi
The Next Episode (feat. Snoop Dogg) :: Dr. Dre
The Man Who Can't Be Moved :: The Script
The Man :: The Killers
The Man :: Aloe Blacc
The Love Club :: Lorde
The Lion Sleeps Tonight (Wimoweh) :: The Tokens
The Less I Know The Better :: Tame Impala
The Ketchup Song (Aserejé) (Spanglish Version) :: Las Ketchup
The Lazy Song :: Bruno Mars
The Ketchup Song (Aserejé) (Spanish Version) :: Las Ketchup
Xaphoon Jones - The Jackson Pit (Passion Pit vs Jackson 5) :: College of Music
Billy Kenny - The Hood Girl :: Relief
The Hills :: The Weeknd
Delibes: The Flower Duet (From "Lakmé") :: Katherine Jenkins, Kiri Te Kanawa, Philharmonia Orchestra, Anthony Inglis
The Embassy Waltz (Instrumental) :: André Previn, My Fair Lady Original Motion Picture Cast, & The Warner Bros. Orchestra
The Days :: Avicii
The Club Is Alive :: JLS
The Closest Thing To Crazy :: Katie Melua
The Cave :: Mumford & Sons
The Brightest Lights (feat. Mumford & Sons) :: King Charles
The Blue Danube :: Johann Strauss, Jr.
The Big Bang :: Rock Mafia
The Best Day :: Atmosphere, Slug, Ant
The Beat (feat. Zøe) :: Sam Paganini
THE BANJO BEAT :: RICKY DESKTOP
Thé à la menthe (The Lazer Dance Version) :: La Caution
That's What I Like :: Bruno Mars
That's Not My Name :: The Ting Tings
djDOYOU That Girl Worth Fighting For (Mulan vs. Wayne, Pharrell, Gucci Mane) :: Paul Gongaware
Tequila :: Jax Jones, Martin Solveig, RAYE, Europa
Tennis Court :: Lorde
Temperature :: Sean Paul
Telescope (feat. Transviolet) :: Tim Legend
Teenagers :: My Chemical Romance
Teenage Dirtbag :: Wheatus
Technologic :: Daft Punk
Techno Fan :: The Wombats
Team :: Lorde
Teach Me How to Dougie :: Cali Swag District
Tangled Up (Lokee Remix) :: Caro Emerald
Tangled Up :: Caro Emerald
Talk Dirty (feat. 2 Chainz) :: Jason Derulo
Talk :: Castaway Tom, Shai
TaKillYa (Baby Driver Mix) :: Vinnie Maniscalco
Take Your Shirt Off :: T-Pain
Take Your Mama :: Scissor Sisters
Take Over Control [Radio Edit] (feat. Eva Simons) :: Afrojack
Take It Off :: Kesha
Take It :: Dom Dolla
Take a Walk :: Passion Pit
Take A Pill :: Mike Vallas
T-Shirt :: Shontelle
Sweet Lullaby (Version 1992) :: Deep Forest
Sweet Like Chocolate (Shanks & Bigfoot Original Mix) :: Shanks & Bigfoot
Sweet Dreams (Are Made of This) [2018 Remastered] :: Eurythmics
Sweet Disposition :: The Temper Trap
Sweat (Snoop Dogg vs David Guetta Remix) :: Snoop Dogg, David Guetta
Swalla (feat. Nicki Minaj & Ty Dolla $ign) :: Jason Derulo, Nicki Minaj, Ty Dolla $ign
Sushi :: Kyle Andrews
Surround You :: Echosmith
Superstar :: Jamelia
Boombox Cartel - Supernatural (Hundaes Remix) ft. Anjulie :: CloudKid
Supermassive Black Hole :: Muse
Superlove (feat. Oh Wonder) :: Whethan
Superbad :: Flux Pavilion, Doctor P
Supalonely (feat. Gus Dapperton) :: BENEE
Sunshine, Lollipops And Rainbows :: Lesley Gore
Sunshine Girl :: moumoon
Sunshine :: Atmosphere, Slug, Ant
Sunny :: Papa Ya
Sunny :: Boney M.
Sunlight (feat. Years & Years) :: The Magician
Sunflower (Spider-Man: Into the Spider-Verse) :: Post Malone, Swae Lee
This Love :: Maroon 5
Sunday Morning :: Maroon 5
Sun of a Gun :: Oh Land
Sun Is Shining :: Axwell /\ Ingrosso, Sebastian Ingrosso
Summer in the City :: The Lovin' Spoonful
Summer Paradise [Single Version] (feat. Sean Paul) :: Simple Plan
Sugar, We're Goin Down :: Fall Out Boy
Sugar (feat. Francesco Yates) :: Robin Schulz
Sugar :: Maroon 5
Suddenly I See :: KT Tunstall
djDOYOU Stuntin Like Mufasa (Simba vs. Lil Wayne) :: Paul Gongaware
Stuck In The Middle With You :: Stealers Wheel
Stronger :: Kanye West
Strip That Down (feat. Quavo) :: Liam Payne
Strike a Pose (feat. Aitch) :: Young T & Bugsey
Street Punks :: Vince Staples
Stop And Stare :: OneRepublic
Stolen Dance :: Milky Chance
Stofnar Falla :: Samaris
Stick to the Status Quo :: High School Musical Cast, Disney
Stitches :: Shawn Mendes
Stereo Love (Extended Mix) (feat. Vika Jigulina) :: Edward Maya
Steal My Sunshine (Single Version) :: Len
Stayin Alive :: Bee Gees
Stay High (Habits Remix) (feat. Hippie Sabotage) :: Tove Lo
Stay :: Zedd, Alessia Cara
Stay (feat. Mikky Ekko) :: Rihanna
Stay (feat. Maty Noyes) :: Kygo
Start Without You (feat. Laza Morgan) :: Alexandra Burke
Starry Eyed :: Ellie Goulding
Starlight :: Jasmine Ash
Stand By Me :: Ben E. King
Stamp On The Ground :: ItaloBrothers
Stacy's Mom :: Fountains Of Wayne
Spread Love (Paddington) (feat. DVNO) :: Boston Bun
Spooky :: Dusty Springfield
Spirit In The Sky (Deluxe Edition) :: Norman Greenbaum
Sparks :: Cover Drive
Space Tube 25 :: Captain Hook
Soy Yo :: Bomba Estéreo
Sound Of The Underground :: Girls Aloud
Sorry :: Justin Bieber
Sonnentanz (Sun Don't Shine) (feat. Will Heard) :: Klangkarussell
Somewhere to Run :: Krewella
Somewhere Over The Rainbow/What A Wonderful World :: Israel Kamakawiwo'ole
Somewhere Only We Know :: Lily Allen
Somewhere Only We Know :: Keane
(It Happens) Sometimes [Extended Mix] :: Jack Back
something there on top of the world :: clockfaw
Something Just Like This :: The Chainsmokers, Coldplay
(Something Inside) So Strong :: Labi Siffre
Something About Us :: Daft Punk
Someone Like You :: Adele
Somebody to Love (Main Club Mix) :: Boogie Pimps
Somebody That I Used To Know (feat. Kimbra) :: Gotye
Somebody Like Me (Mark With a K Remix) :: Xillions
Some Nights :: fun.
Solo Dance :: Martin Jensen
So Lost :: Ady Suleiman
So Good :: Louisa Johnson
So Good :: B.o.B
So :: MadColour
Smile :: Nat King Cole
L-O-V-E :: Nat King Cole
Sleigh Ride :: Pentatonix
Sleepyhead :: Passion Pit
Skip To The Good Bit :: Rizzle Kicks
Skinny Love :: Birdy
Skinny Genes :: Eliza Doolittle
(Sittin' On) the Dock of the Bay :: Otis Redding
Sk8er Boi :: Avril Lavigne
Sit Still, Look Pretty :: Daya
Sister Wife :: Alex Winston
Sinner (feat. Keynes Woods) :: Francis Novotny
Single Ladies (Put a Ring on It) :: Beyoncé
Singin' in the Rain :: Mint Royale
Silver Lining :: Rilo Kiley
Since U Been Gone :: Kelly Clarkson
Silence :: Loosid
Signs (feat. Charlie Wilson & Justin Timberlake) :: Snoop Dogg
Side to Side (feat. Nicki Minaj) :: Ariana Grande
Sick Boy :: The Chainsmokers
Shut Up And Drive :: Rihanna
Shut Up :: The Black Eyed Peas
Shut Eye :: Stealing Sheep
Shut Up and Dance :: WALK THE MOON
Shots & Squats (feat. Tham Sway) :: Vigiland
Shotgun :: George Ezra
Shot Me Down [Radio Edit] (feat. Skylar Grey) :: David Guetta
Shine Your Way :: Owl City, Yuna
Shine :: Take That
She's The One :: Robbie Williams
She's So Lovely :: Scouting For Girls
She's so High :: Tal Bachman
She Works Out Too Much :: MGMT
She Moves In Her Own Way :: The Kooks
She Loves Control :: Camila Cabello
She Looks So Perfect :: 5 Seconds of Summer
She Knows (feat. Juicy J) :: Ne-Yo
She Doesn't Mind :: Sean Paul
She :: Elvis Costello
Shaky Shaky :: Daddy Yankee
Shake It Off :: Taylor Swift
Shadow :: Triplo Max
Sexy Bitch (feat. Akon) :: David Guetta
Sexy And I Know It :: LMFAO
Sexual (feat. Dyo) :: NEIKED
Sex on the Beach (Paolo Ortelli Vs Degree Reloaded Video Edit) :: Spankers
Sex on Fire :: Kings Of Leon
Sex (Radio Edit) :: Cheat Codes, Kris Kross Amsterdam
Seven Nation Army (The Glitch Mob Remix) :: The White Stripes, The Glitch Mob
Seven Nation Army :: Holly Henry
September Song :: JP Cooper
Senpai (feat. Hentai Dude) :: Shiki-TMNS
Señorita :: Justin Timberlake
Senor Loco (feat. Danny Mazo) :: Elena
Secrets (feat. Vassy) :: Tiësto, KSHMR
Secrets :: OneRepublic
Say Something :: A Great Big World
Say Something :: Pentatonix
Say Something (Radio Edit) :: Nasser Baker
Say So :: Doja Cat
Say My Name :: Destiny's Child
Savage Love (Laxed - Siren Beat) :: Jawsh 685, Jason Derulo
Savage (feat. Flux Pavilion & MAX) :: Whethan
Satisfied (feat. MAX) :: Galantis
Satisfaction (Uk Radio Edit) :: Benny Benassi, The Biz
Satellite Heart :: Anya Marina
Sandstorm (Radio Edit) :: Darude
Same Love (feat. Mary Lambert) :: Macklemore & Ryan Lewis
Same Jeans :: The View
Salute :: Little Mix
Safe and Sound :: Capital Cities
S.L.U.T. :: Bea Miller
Runaway (U & I) :: Galantis
Runaway (feat. ChianoSky) :: Jaydon Lewis
Run Wild :: Thutmose, NoMbe
Run This Town (feat. Rihanna & Kanye West) :: JAY-Z
Run the World (Girls) :: Beyoncé
Run Boy Run :: Woodkid
Run :: Snow Patrol
Run (I'm a Natural Disaster) :: Gnarls Barkley, CeeLo Green, Danger Mouse
Crazy :: Gnarls Barkley, CeeLo Green, Danger Mouse
Sail :: AWOLNATION
Run :: AWOLNATION
Rum & RedBull :: Seanizzle, Beenie Man, Future Fambo
Rude Boy :: Rihanna
Rude :: MAGIC!
Ruby :: Kaiser Chiefs
Royals :: Lorde
Roses (feat. ROZES) :: The Chainsmokers
ROXANNE :: Arizona Zervas
Roses (Imanbek Remix) :: SAINt JHN
Rooftops :: Harry Nathan
Romeo :: Basement Jaxx
Rolling in the Deep :: Adele
rockstar (feat. 21 Savage) :: Post Malone
Rockstar :: Nickelback
Rocket :: Beyoncé
Rock This Party (Everybody Dance Now) (feat. DollarMan, Big Ali & Makedah) :: Bob Sinclar, Cutee B.
Rock That Body :: The Black Eyed Peas
Rock Star :: Prima J
Riverside :: Sidney Samson
Rise (feat. Jack & Jack) :: Jonas Blue
Riptide :: Vance Joy
Right Time (feat. Aria Ohlsson) :: Robotaki
Right Round (feat. Ke$ha) :: Flo Rida
Right Here, Right Now (CamelPhat Remix) :: Fatboy Slim
Riff Off (From "Pitch Perfect 2" Soundtrack) :: Das Sound Machine, Tone Hangers, The Barden Bellas, Green Bay Packers
Riff Off: Mickey/Like A Virgin/Hit Me With Your Best Shot/S&M/Let’s Talk About Sex/I’ll Make Love To You/Feels Like The First Time/No Diggity :: The Barden Bellas, The Treblemakers, The Bu Harmonics
Ridin' Solo :: Jason Derulo
Ride :: Lana Del Rey
Rich :: MAYKA
Revolution (feat. Imanos & Faustix & Kai, Faustix & Kai) :: Diplo
Resonance (feat. Talay Riley) :: LuvBug
Resonance :: HOME
Replay :: Iyaz
Remember the Name (feat. Styles of Beyond) :: Fort Minor
Relax, Take It Easy :: MIKA
Rehab :: Amy Winehouse
Reggaetón Lento (Remix) :: CNCO
Reality (feat. Janieck) :: Lost Frequencies
Real Friends :: Camila Cabello
...Ready For It? (BloodPop® Remix) :: Taylor Swift, BloodPop®
...Ready For It? :: Taylor Swift
Read My Mind :: The Killers
Ray Charles :: Chiddy Bang
Rave - Sam Paganini :: Empty Artist - Topic
Rather Be (feat. Jess Glynne) :: Clean Bandit
Nightcore - Rasputin (Remix) :: NightcoreLounge
Rap God :: Eminem
Rama Lama Ding Dong :: Rocky Sharpe & The Replays
Raingurl :: Yaeji
Raindrops (Radio Edit) (feat. Kerli) :: SNBRN
Rain :: The Script
Rage Valley :: Knife Party
Radioactive :: Imagine Dragons
Radio :: Lana Del Rey
Radar Detector :: Darwin Deez
Rabbit Hole :: CamelPhat
R U Crazy :: Conor Maynard
Quarterback :: Kopecky
Put Your Records On :: Corinne Bailey Rae
Put Your Hands Up For Detroit (Radio Edit) :: Fedde Le Grand
Pushing On :: Oliver Dollar, Jimi Jules
Push The Button :: Sugababes
Push Pull (Club Mix) :: OFFAIAH
Pursuit Of Happiness (nightmare) (feat. MGMT & Ratatat) :: Kid Cudi
Pursuit Of Happiness (Extended Steve Aoki Remix) (feat. MGMT & Ratatat) :: Kid Cudi
Purple Lamborghini :: Skrillex, Rick Ross
Purple Noise :: Boris Brejcha
Pure Shores :: All Saints
Pure Imagination :: Dotan Negrin + Prismatic Mantis
Pure Imagination :: Kathleen
Pumpin Blood (The Jane Doze Remix) :: NONONO
Foster the People - Pumped Up Kicks (Aiju Remix) :: Azeria
Pumped Up Kicks :: Foster The People
Pump It Up :: Endor
Pump It :: The Black Eyed Peas
Pump :: Valentino Khan
Pull Me Down :: Mikky Ekko
Psycho Killer (2005 Remaster) :: Talking Heads
Promiscuous (feat. Timbaland) :: Nelly Furtado
prom dress :: mxmtoon
Princess of China :: Coldplay, Rihanna
Primadonna :: MARINA
Price Tag (feat. B.o.B) :: Jessie J
Pretty Girl :: Maggie Lindemann
Prayer in C (Robin Schulz Radio Edit) :: Lilly Wood & The Prick, Robin Schulz
Praise You :: Fatboy Slim
Praise You (Purple Disco Machine Extended Remix) :: Fatboy Slim
Powerful (feat. Tarrus Riley) :: Major Lazer, Ellie Goulding
POWER :: Kanye West
Pour The Milk (Extended Mix) :: Robbie Doherty, Keees.
Post to Be (feat. Chris Brown & Jhene Aiko) :: Omarion
Everybody Home :: PRD Music
The Meemies - Porch Song :: Hakarat
Popular Song (feat. Ariana Grande ) :: MIKA
Pop Culture :: Madeon
PONPONPON :: Kyary Pamyu Pamyu
Pon De Floor (feat. Vybz Kartel) :: Major Lazer
Poison :: Rita Ora
Point Blank :: Ben Klock
Anna Kendrick, Kendrick Lamar ft. Drake, Florence and the Machine - Poetic :: Isosine
Pinga [Extended Mix] (feat. Sito Rocks) :: Sak Noel, Luka Caro, Ruben Rider
Pinball (Max Kay Remix Radio) :: CCK
P.I.M.P. :: 50 Cent
Piece Of Your Heart :: MEDUZA, Goodboys
Photograph :: Ed Sheeran
Itsi Bitsi Bikini (French Version) :: Gummibär
Peter Pan (feat. Antonin & Vico) :: Polo & Pan
Perfect to Me :: Anne-Marie
Perfect (Exceeder) :: Mason - Topic
Perfect :: Fairground Attraction
Peanut Butter Jelly :: Galantis
Peaches :: In The Valley Below
Pays imaginaire :: Polo & Pan
Pass Out :: Tinie Tempah
Pass At Me (feat. Pitbull) :: Timbaland
Party Rock Anthem (feat. Lauren Bennett & GoonRock) :: LMFAO
Party In The U.S.A. :: Miley Cyrus
Part of the Game :: Point Point
Paradise :: Coldplay
Paper Planes :: M.I.A.
Paper Love :: Allie X
Panini :: Lil Nas X
Panic Room :: CamelPhat
Panda :: Desiigner
Pack Up :: Eliza Doolittle
Oxford Comma :: Vampire Weekend
Hot Chip - Over and Over (Soulwax Remix) [1080p] :: Minimus
Outro :: M83
Opposite of Adults :: Chiddy Bang
Ooh Wee (feat. Ghostface Killah, Nate Dogg, Trife & Saigon) :: Mark Ronson
Witch Doctor (Radio Mix) :: Cartoons
Ooh Ahh (My Life Be Like) (feat. TobyMac) :: Grits
One Week :: Barenaked Ladies
One Time :: Marian Hill
One Thing :: One Direction
One More Time :: Daft Punk
One Day Like This :: Elbow
One Click Headshot :: Feed Me
One :: Sky Ferreira
Main Title / Once Upon A Dream / Prologue (From "Sleeping Beauty"/Soundtrack Version) :: Chorus - Sleeping Beauty
Once in a Lifetime (2005 Remaster) :: Talking Heads
On Your Mind :: Kaskade
On Top Of The World :: Imagine Dragons
On To The Next One (feat. Swizz Beatz) :: JAY-Z
On My Mind :: Diplo, SIDEPIECE
On Melancholy Hill :: Gorillaz
OMG (feat. will.i.am) :: Usher
Old Town Road (Remix) (feat. Billy Ray Cyrus) :: Lil Nas X
Oino :: LA Priest
Ooh Tune :: Shadow Child
Oh No You Didn't (Mercenaries 2 Anthem) :: Wojahn Bros
Capone - Oh No (TikTok Remix) Lyrics | Oh no, oh no, oh no no :: SyrebralVibes
Oh My Love :: The Score
Oh My Gosh :: Basement Jaxx
Oh Cecilia (Breaking My Heart) :: The Vamps
Off To The Races :: Lana Del Rey
Ocean Man :: Ween
Oblivion (feat. Lola Blanc) :: TheFatRat
Never Be Alone :: TheFatRat
Nympho :: Borgore
Numb / Encore :: Jay-Z, Linkin Park
Now You're Gone (Radio Edit) :: Basshunter
All I Ever Wanted (Radio Edit) :: Basshunter
Now You're Gone [Video Edit] (feat. DJ Mental Theo's Bazzheadz) :: Basshunter
Notorious :: The Saturdays
Nothin' on You (feat. Bruno Mars) :: B.o.B
Not Giving In (feat. John Newman & Alex Clare) :: Rudimental
Not Afraid :: Eminem
Frédéric Chopin: Nocturne in E-Flat Major, Op. 9, No. 2 :: Vadim Chaimovich
No Surprises :: Radiohead
Nobody To Love (Extended Mix) :: Sigma
No Type :: Rae Sremmurd
No Scrubs (feat. Joanna Jones) :: Unlike Pluto
No Games :: Serani
No Church In The Wild (feat. Frank Ocean & The-Dream) :: JAY Z, Kanye West
No Boyfriend (Extended Vocal Mix) (feat. Mayra Verónica) :: Sak Noel, DJ Kuba, Neitan
No Air (feat. Chris Brown) :: Jordin Sparks
Nine in the Afternoon :: Panic! At The Disco
Nightcall :: Kavinsky
Niggas in Paris (DJ Quick Remix Version) :: Jay-Z & Kanye West
Next To Me :: Emeli Sandé
New York (Radio Edit) :: Paloma Faith
Yael Naim- New Soul (Tik Tok Remix) :: Musical Sounds
Yael Naim - New Soul (FAST) :: Rhythmic Vicks
21twelve - New Soul :: SwagyTracks
New Soul :: Yael Naim
New Horizons :: Rameses B
Nevermind :: Dennis Lloyd
Abstract - Neverland (Prod. Blulake) :: Chill Nation
Never Tear Us Apart :: Paloma Faith
djDOYOU Never Had An Ice Cream Paint Job (Aladdin vs. Dorrough) :: Paul Gongaware
Never Forget You :: Zara Larsson, MNEK
Never Ever :: All Saints
Never Be the Same :: Camila Cabello
Never Be Lonely :: The Feeling
Never Be Like You :: Flume, Kai
Never Be Alone :: TheFatRat
Nilow - ( Lisa Mitchell ) - Neopolitan Dreams - Dubstep Remix :: AldoKria
Neopolitan Dreams :: Lisa Mitchell
Neck And Neck (feat. Dragonette) :: Zeds Dead
Natural :: Imagine Dragons
Nanã :: Polo & Pan
Mysterious Girl (Radio Edit) :: Peter Andre
My Way :: Aloe Blacc
My Type :: Saint Motel
My Oh My (feat. DaBaby) :: Camila Cabello
My Nigga (feat. Jeezy & Rich Homie Quan) :: YG
My Money (feat. Molly) :: SEREBRO
My LSD Song :: Bliss
My Life Would Suck Without You :: Kelly Clarkson
My Humps :: The Black Eyed Peas
My Jolly Sailor Bold :: Acapella Onion
My House :: Flo Rida
My High :: Disclosure, slowthai
My Guy :: Mary Wells
My Favourite Game :: The Cardigans
My Darling :: Dooqu
Marbert Rocel - My Bed (Nico Pusch Bootleg Remix) :: TOKAIDO
my boy :: Billie Eilish
Music :: Madonna
Mundian to Bach Ke :: Panjabi MC
The Chordettes - Mr. Sandman (OFFICIAL TRAP REMIX) :: Trap Music Now
THE CHORDETTES - MR. SANDMAN (OFFICIAL TRAP REMIX) :: Trap Music Now
Lonely :: Akon
The Killers - Mr. Brightside (Two Friends Remix) :: Trap Nation
Mr. Brightside :: The Killers
Mr. Blue Sky :: Electric Light Orchestra
Motorola :: Gorgon City
Moskau :: Dschinghis Khan
Mortal Loucura :: Caetano Veloso, José Miguel Wisnik
Morning After Dark (feat. Nelly Furtado & Soshy) :: Timbaland
Morenita (Flashmob Remix) :: Ilary Montanari & Alé Kumá
Morenita :: Ilary Montanari
More Than You Know :: Axwell /\ Ingrosso
More Colors (feat. Chelsea Cutler) :: Kidswaste
More (RedOne Jimmy Joker Remix) :: Usher
Moonlight :: Gaullin
Moon (And It Went Like) :: Kid Francescoli, Julia Minkin
Mood (feat. iann dior) :: 24kGoldn
Monster (DotEXE Remix) :: Meg & Dia
Molly (Extended Mix) :: Cedric Gervais
Moan (Trentemøller Remix) :: Trentemøller
Mmm Yeah (feat. Pitbull) :: Austin Mahone
Misery :: Maroon 5
Mine :: Phoebe Ryan
Mine :: Bazzi
Million Voices :: Otto Knows
Million Dollar Man :: Lana Del Rey
Kelis - Milkshake (TRFN Remix) :: TRFN
Milkshake :: Kelis
Mile Marker :: Amy Seeley
Midnight City :: M83
Mi Mi Mi :: Serebro
Mi Gente :: J. Balvin, Willy William
MGMT vs. Daft Punk vs. Passion Pit vs. Gorillaz vs. Bob Marley :: Sim Gretina
Mexicali :: Polo & Pan
Memories (feat. Kid Cudi) :: David Guetta
Meet Me Halfway :: The Black Eyed Peas
Meet Me :: Mickey Valen, Noé
G-Eazy & Bebe Rexha - Me, Myself & I (No Sleep Remix) :: G-Eazy, Bebe Rexha
Me, Myself & I :: G-Eazy
Me Without You :: Loick Essien
Matches :: Cash Cash, ROZES
Marvin Gaye (feat. Meghan Trainor) :: Charlie Puth
Marry You :: Bruno Mars
Mark My Words :: MOTHICA
Marijuana Breath :: Adam Jensen
Many the Miles :: Sara Bareilles
Disney's The Jungle Book, Busta Rhymes - Man's Red Fire (You Might Burn Yourself) (Smija Mashup) :: Jake Smith
Man! I Feel Like A Woman! :: Shania Twain
Mambo No. 5 (a Little Bit of...) :: Lou Bega
Mama Do The Hump :: Rizzle Kicks
Mama :: Jonas Blue, William Singe
Makeba :: Jain
Make You Feel My Love :: Adele
Make You Mine (Radio Edit) :: PUBLIC
Make U Bounce (Radio Edit) :: DJ Fresh, TC
Make Someone Happy :: Jimmy Durante
Make Me Feel So Good (feat. Roo Savill) :: Adam Skinner & Dan Skinner, Dave James
Make It Bun Dem :: Skrillex, Damian "Jr Gong" Marley
Make Better (feat. Raquel Rodriguez) :: Intuition & Equalibrum
Miami 2 Ibiza (Swedish House Mafia vs. Tinie Tempah) :: Swedish House Mafia, Tinie Tempah
Magic (feat. Rivers Cuomo) :: B.o.B
Madness :: Muse
Mad World (feat. Haley Reinhart & Puddles Pity Party) :: Scott Bradlee's Postmodern Jukebox
Mad World :: Gary Jules, Michael Andrews
Macarena :: Los Del Rio
Lumberjackin' (Vocal Mix) :: Serum, Inja
L$D :: A$AP Rocky
LoveStoned / I Think She Knows (Interlude) :: Justin Timberlake
Lovers on the Sun (feat. Sam Martin) :: David Guetta
Love Yourself :: Justin Bieber
Love You More :: Mount Cashmore
Love Story :: Taylor Swift
Love Sex Magic (feat. Justin Timberlake) :: Ciara
Love on Me :: Galantis, Hook N Sling
Love Me Like You Do :: Ellie Goulding
Love Me Like You :: Little Mix
Love It When You Call :: The Feeling
Love is Gonna Save Us (Benny Extra Long Mix) (Benny Benassi Presents The Biz) :: Benny Benassi, The Biz
Love Is All Around (From "Four Weddings And A Funeral") :: Wet Wet Wet
Love Is Alive :: Louis The Child, Elohim
Love Is A Drug :: Empress Of
Love in This Club (feat. Young Jeezy) :: Usher
LoveGame :: Lady Gaga
Love Again :: Rae Morris
Love :: Borgore
Louder (Radio Edit) (feat. Sian Evans) :: DJ Fresh
Losing It :: FISHER
Lost on You :: LP
Lose Yourself :: Eminem
Lose Control (feat. Ciara & Fatman Scoop) :: Missy Elliott
Look What You Made Me Do :: Taylor Swift
Look At Me Now (feat. Lil' Wayne & Busta Rhymes) :: Chris Brown
Lone Digger :: Caravan Palace
Lollipop (From "Pitch Perfect 2" Soundtrack) :: The Treblemakers
Lollipop :: MIKA
Lollipop (Remix) (feat. Static Major & Kanye West) :: Lil Wayne
Lola (2020 Stereo Remaster) :: The Kinks
Locked Away (feat. Adam Levine) :: R. City
Loca People :: Sak Noel
LOAH :: Klaus Blatter
Live While We're Young :: One Direction
Little Things Mean a Lot (feat. Emily Harvey & Jack Durtnall) :: Little Shoes Big Voice
Little Talks :: Julia Sheer & Jon D
Little Talks :: Of Monsters and Men
Little Swing :: AronChupa & Little Sis Nora
Little Lion Man :: Mumford & Sons
886Beatz -Little Einsteins Remix :: 886Beatz
Little Dark Age :: MGMT
Little Boxes :: Walk Off The Earth
Little Boxes (feat. Adrienne Stiefel) :: Sniffy Dog
Liquid Slow :: Charlotte de Witte, Chris Liebing
Lips Are Movin :: Meghan Trainor
Linger :: The Cranberries
Like Me (From "Teen Beach Movie"/Soundtrack Version) :: Maia Mitchell, Grace Phipps, Brady, Spencer Lee, and Teen Beach Movie Cast
SAVED ME :: Jake Miller
Like I'm Gonna Lose You (feat. John Legend) :: Meghan Trainor
Like A G6 :: Far East Movement, The Cataracs, DEV
Like A Boss :: Eptic
Lightning Bolt :: Jake Bugg
Light of the Seven :: Ramin Djawadi
Light It Up (feat. Nyla & Fuse ODG) [Remix] (feat. Fuse ODG & Nyla) :: Major Lazer
Lifetime :: Romy
Lifeline (feat. Dana Williams) :: MELVV
Life Itself :: Glass Animals
Life is a Highway :: Rascal Flatts
Lick It :: Valentino Khan
Let You Get Away [Extended Mix] (feat. Ashe) :: Shaun Frank
Let the Sun Shine :: Labrinth
Let The Bass Kick In Miami Girl (Extended Mix) :: Chuckie, LMFAO
Let Me Think About It :: Ida Corr, Fedde Le Grand
Let Me Go :: Maverick Sabre
Let Me Down Slowly :: Alec Benjamin
Let It Roll :: Flo Rida
Let It Happen :: Tame Impala
A$AP FERG feat. Queen Elsa - Let it Go :: TheFools Fortissimo
Let Her Go :: Passenger
Let Go for Nothing :: Husky Loops
Les passants :: Zaz
The Show :: Lenka
LEMONADE :: SOPHIE
Left Hand Free :: alt-J
Leaving It Up to You :: George Ezra
Lean On Me :: Glee Cast
Lean On (feat. Major Lazer & DJ Snake) :: Major Lazer
Le premier bonheur du jour (Stereo Mix) :: Françoise Hardy
Le Festin :: Camille, Michael Giacchino
Lazy Kisses :: JT Roach
Lay All Your Love On Me (From 'Mamma Mia!' Original Motion Picture Soundtrack) :: Dominic Cooper, Amanda Seyfried
late nights :: mxmtoon
Disclosure x Whethan x Louis The Child - Latch It Up (feat. Sam Smith) :: CloudKid
Latch (feat. Sam Smith) :: Disclosure
Last Time :: Labrinth
Last Request :: Paolo Nutini
Last Night :: The Vamps
Last Friday Night (T.G.I.F.) :: Katy Perry
Morten Breum - Larva (Far Away) (Pegboard Nerds Remix) :: Thrilling Music
L'amour Toujours :: Gigi D'Agostino
Carmen, Act 1: "L'amour est un oiseau rebelle" (Carmen) :: Maria Callas, Georges Bizet
Lalala :: Y2K, bbno$
Laissez-moi :: Zaz
Lady Marmalade (From "Moulin Rouge" Soundtrack) :: Christina Aguilera, Lil' Kim, Mya, P!nk
Ladbroke Grove :: AJ Tracey
Requiem Mass in D Minor, K. 626: III. Lacrimosa :: RIAS Chamber Choir, Berlin Radio Symphony Orchestra, Uwe Gronostay, Wolfgang Amadeus Mozart
La Rompe Corazones (feat. Ozuna) :: Daddy Yankee
La Passion :: Gigi D'Agostino
Green Velvet - La la land :: Jc Fabela
la la la that’s how it goes :: HONNE
L.I.F.E.G.O.E.S.O.N. :: Noah And The Whale
Kuessen Kann Man Nicht Alleine (Wolfgang Lohr Remix) :: Wolfgang Lohr
Knock You Down (feat. Kanye West & Ne-Yo) :: Keri Hilson
Kisses for Breakfast (feat. Popcaan) :: Melissa Steel
Kisses Back :: Matthew Koma
Kiss Me :: Sixpence None The Richer
Kiss Kiss (feat. T-Pain) :: Chris Brown
King And Cross :: Ásgeir
Killin' It (KillaGraham Remix) :: Krewella
Killer Queen :: Queen
Kids :: MGMT
Katy on a Mission :: Katy B
Keep On Movin' :: Five
Keep It Mello (feat. Omar LinX) :: Marshmello
Kanye (feat. SirenXX) :: The Chainsmokers
Just the Way You Are :: Bruno Mars
Just Like a Pill :: P!NK
Just Freakin' (original mix) :: Freakadelika
Just For Show :: Atmosphere, Slug, Ant
Just Dance (feat. Colby O'Donis) :: Lady Gaga
Just Can’t Get Enough :: The Black Eyed Peas
Diamond Day :: Vashti Bunyan
Just A Girl :: No Doubt
Jungle Skank 2010 (feat. Ashman) :: JP Tronik
Jungle :: Emma Louise
jump (feat. Sofi de la Torre) :: gabriel black
Jump (feat. Nelly Furtado) :: Flo Rida
Juice :: Lizzo
Jubel :: Klingande
Johanna :: Jamie Campbell Bower
Jenny (I Wanna Ruin Our Friendship) :: Studio Killers
Jealous :: Nick Jonas
Je Mappelle Funny Bear :: Gummibär
jar of hearts :: christina perri
Jaigantic (Galimatias Remix) :: Tora
J’ai pas envie :: MIKA
Jackie Chan (feat. Preme & Post Malone) :: Tiësto, Dzeko
Jack :: Breach
Always with Me (Itsumo Nando Demo) Lyrics: Kanji, Japanese, and English Spirited Away Studio Ghibli :: EasyCook’N
It's Tricky :: RUN DMC
It's Oh So Quiet :: Björk
It’s My Birthday (feat. Cody Wise) :: will.i.am
It Makes You Forget (Itgehane) :: Peggy Gou
It Girl :: Jason Derulo
It Can Wait (feat. Owl Eyes) :: Illy
Istanbul (Not Constantinople) :: They Might Be Giants
Issues :: Julia Michaels
Ironic :: Alanis Morissette
Invincible (Manila Killa Remix) (feat. iDA HAWK) :: Big Wild
Invincible :: DEAF KEV
Intro :: The xx
Intoxicated :: Martin Solveig & GTA
Internet Friends :: Knife Party
Interlude (That's Love) :: Chance the Rapper
Instruction (feat. Demi Lovato & Stefflon Don) :: Jax Jones
Insomnia :: Faithless
Inochi no Namae ( The name of Life ) - Spirited Away :: Shibulilbby
Indian Summer :: Jai Wolf
In Your Eyes :: Kylie Minogue
In Too Deep :: Sum 41
In the Morning :: The Coral
In the Morning :: Jaded
In My Mind (Extended Version) :: Dynoro, Gigi D'Agostino
Imagine :: John Lennon
Imagination :: Labrinth
I'm Yours :: Jason Mraz
I'm the One (feat. Justin Bieber, Quavo, Chance the Rapper & Lil Wayne) :: DJ Khaled
i'm so tired... :: Lauv, Troye Sivan
I'm Not The Only One :: Sam Smith
I'm Just a Kid :: Simple Plan
I'm in love with you :: Shiloh Dynasty
I'm Good :: The Mowgli's
I'm an Albatraoz :: AronChupa & Little Sis Nora
I’m Alive (Life Sounds Like) :: Michael Franti & Spearhead
I'm A Freak (feat. Pitbull) :: Enrique Iglesias
Illusion :: Deeco
Ignition (Remix) :: R.Kelly
If You're Over Me :: Olly Alexander (Years & Years)
If You Want To :: DIMENSION
If You Wanna :: The Vaccines
If We Ever Meet Again (feat. Katy Perry) :: Timbaland
If My Heart Was a House :: Owl City
If I Die Before You :: Ludwig Goransson
I'd Love To Change The World (Matstubs Remix) :: Jetta
Ice Cream :: Borgore
I Wish I Was James Bond :: Scouting For Girls
I Want You Back :: Jackson 5
I Wanna Go :: Britney Spears
I Vow to Thee, My Country :: Choir of King's College, Cambridge, Peter Stevens, Stephen Cleobury, Gustav Holst
I Try Hard :: Yael Naim
I Try :: Macy Gray
I Think We're Alone Now (Re-Recorded) :: Tiffany
I Think I Like It :: Fake Blood
I Still See Your Face :: San Holo
I Started a Joke (feat. Becky Hanson) :: ConfidentialMX
iSpy (feat. Lil Yachty) :: KYLE
I Never Told You :: Colbie Caillat
I Really Like You :: Carly Rae Jepsen
I Need You Tonight (feat. Ed Drewett) :: Professor Green
I Need Air (feat. Angela Hunte) :: Magnetic Man
I Need A Dollar :: Aloe Blacc
I miss the old u :: blackbear
I Like You So Much Better When You`re Naked :: Ida Maria
I Love You :: OMFG
I Love It :: Kanye West, Lil Pump
I Lived :: OneRepublic
I Like Me Better :: Lauv
I Like It :: Enrique Iglesias
I Like It :: Cardi B, Bad Bunny, J Balvin
I Know (Radio Edit) :: Shift K3Y
I Just Can't Wait To Be Badd (The Lion King + Ying Yang Twins & Mike Jones) :: ScrillionaireMusic
I Gotta Feeling :: The Black Eyed Peas
I Follow Rivers :: Lykke Li
I Feel Pretty / Unpretty (Cover of 'West Side Story' and TLC) :: Glee Cast
I Don't Like It, I Love It (feat. Robin Thicke & Verdine White) :: Flo Rida
I Don't Feel Like Dancin' :: Scissor Sisters
I Do This (feat. RoZe) :: Abstract
I Can't Stop :: Flux Pavilion
I Could Be The One (Avicii Vs. Nicky Romero) (Radio Edit) :: Avicii, Nicky Romero
I Can't Get Enough :: J. Balvin, Selena Gomez, Benny Blanco, Tainy
I Can Transform Ya (feat. Swizz Beatz & Lil' Wayne) :: Chris Brown
I Bet :: Ciara
I Believe in a Thing Called Love (Single Version) :: The Darkness
[Rap Cover] I Am Ur Leader :: Nyanners
I Am Not a Robot :: Marina and The Diamonds
I Already Forgot Everything You Said :: The Dig
Hydrogen :: M|O|O|N
Hunnybee :: Unknown Mortal Orchestra
Human :: The Killers
How We Do (Party) :: Rita Ora
How to Save a Life :: The Fray
How Low :: Ludacris
How Long Will I Love You :: Ellie Goulding
How Long :: Charlie Puth
How I Feel :: Flo Rida
Charmer :: J-VAD
Hotline Bling :: Drake
Hot Right Now (Radio Edit) (feat. RITA ORA) :: DJ Fresh
Hot In Herre :: Nelly
Hooked On A Feeling :: Blue Swede
Hooked :: Notion
Honey, I'm Good :: Andy Grammer
Homecoming (feat. Chris Martin) :: Kanye West
POLO & PAN — Home Sweet Home (the mixtape) :: Polo & Pan
Home Run (Radio Edit) :: Misha B
Home :: Michael Bublé
Home :: Edward Sharpe & The Magnetic Zeros
Holy (feat. Chance The Rapper) :: Justin Bieber
Hollow Moon (Bad Wolf) :: AWOLNATION
Hold Up :: Beyoncé
Hold On :: Rusko, Amber Coffman
Hold Me Close :: Flux Pavilion
Hold Back The River :: James Bay
Hit That :: The Offspring
History :: One Direction
High School Never Ends (Main Version - Explicit) :: Bowling For Soup
High Hopes :: Panic! At The Disco
High Hopes :: Kodaline
High Five :: Sigrid
Hey You There :: Soulja Boy Tell'em
Hey Ya! :: Outkast
Hey There Delilah :: Plain White T's
Hey, Soul Sister :: Train
Hey Now :: Matt and Kim
Hey Man (Now You're Really Living) :: Eels
Hey Mami :: Sylvan Esso
Hey Hey (DF's Attention Vocal Mix) :: Dennis Ferrer
Hesher :: Wallpaper.
Hero :: Enrique Iglesias
HyperParadise (Flume Remix) :: Hermitude
Here Comes The Sun (Remastered 2009) :: The Beatles
Here Comes the boom :: Nelly Official
Here :: Alessia Cara
Help Me Lose My Mind (feat. London Grammar) :: Disclosure
Hello Kitty :: Avril Lavigne
Hello Hello Hello :: Remi Wolf
Hello Hello Hello (Polo & Pan Remix) :: Remi Wolf
Hello :: OMFG
Hello :: Martin Solveig, Dragonette
HEJ DÅ PAPPA HA DET BRA! (Ft. Malvin Studios) :: Dunderpatrullen
Heaven Is a Halfpipe (If I Die) :: OPM
Heatwave (feat. Ms. D) :: Wiley
Heartbeats :: José González
Heart Vacancy :: The Wanted
Heartbeat :: Scouting For Girls
Heartbeat (feat. Nicole Scherzinger) :: Enrique Iglesias
Heartbeat (Chase & Status We Just Bought A Guitar Mix) :: Nneka
Heads Will Roll (A-Trak Remix) :: Yeah Yeah Yeahs
Headlights (feat. Ilsey) :: Robin Schulz
Hawai'i :: Ana Vee
Haven't Met You Yet :: Michael Bublé
Have A Nice Day :: Stereophonics
Havana (feat. Young Thug) :: Camila Cabello
Harry Potter in 99 Seconds :: Jon Cozart
Harlem Shake :: Baauer
Harder, Better, Faster, Stronger :: Daft Punk
Hard To Love :: Matthew Koma
Hard Times :: Paramore
Happy Ending :: MIKA
Happy (From "Despicable Me 2") :: Pharrell Williams
Happier :: Marshmello, Bastille
Hans Gives Me Hell - Frozen and All American Rejects Mashup :: William Dixon III
Hangover (feat. Flo Rida) :: Taio Cruz
Hands to Myself :: Selena Gomez
Handlebars :: Flobots
HandClap :: Fitz and The Tantrums
Handbags And Gladrags :: Stereophonics
Hallelujah :: Kate Voegele
Hair :: Little Mix
Guess Again :: Plan B
Gucci Store :: Madalen Duke
Gucci Gang :: Lil Pump
GRRRLS :: AViVA
The Groovy Cat (Extended Mix) :: PAWSA
The Groovy Cat :: PAWSA
Grind With Me :: Pretty Ricky
Grind Me Down :: Lilianna Wilde
Ludwig Goransson- Greendale is Where I Belong :: EIapse
graffiti :: SAMAHTA
Grace Kelly :: MIKA
Grace Kelly :: MIKA
Gosh (feat. MC Moose) :: Jamie xx
Going Gorillas :: Doctor P
Gorgeous :: Taylor Swift
Gooey :: Glass Animals
Goodbye Mr A :: The Hoosiers
Good Time :: Owl City, Carly Rae Jepsen
Good Life :: OneRepublic
Good Grief :: Bastille
Good for You (feat. A$AP Rocky) :: Selena Gomez
Good Feeling :: Flo Rida
Good Day :: Jagwar Twin
Good Day :: Nappy Roots
Good as Hell :: Lizzo
Gollum's Song :: Emiliana Torrini
Gold Skies [Radio Edit] (feat. Aleesia) :: Sander van Doorn, Martin Garrix, DVBBS
Golddust :: Dj Fresh
Gold Digger (feat. Jamie Foxx) :: Kanye West
Gold :: LIOHN
Gold :: Kiiara
Gold :: Chet Faker
God Is a DJ :: P!NK
Go! (feat. Mai Lan) :: M83
Go To Sleep (Oshi Remix) (feat. Kailee Morgue) :: Bearson
Go Fuck Yourself :: Two Feet
Glue :: Bicep
Glitterball (feat. Ella Henderson) :: Sigma
Glad You Came :: The Wanted
Giving Up the Gun :: Vampire Weekend
Gives You Hell (Glee Cast Version) :: Glee Cast
Gives You Hell :: The All-American Rejects
Give It To Me (feat. Justin Timberlake & Nelly Furtado) :: Timbaland
Girls Like Girls :: Hayley Kiyoko
Girls :: The 1975
Girlfriend :: Avril Lavigne
Girl Who Cried Wolf :: Ashe
Girl Put In Work (Extended Mix) (feat. Sage Armstrong) :: Will Clarke
Girl Like Me :: Ladyhawke
Ghost :: Ella Henderson
Getting Rid of Britta :: Chevy Chase, Eric Olsen, Tom Wolfe
Get'cha Head In The Game :: Troy, Disney
Get Ur Freak On :: Missy Elliott
Get Ugly :: Jason Derulo
Get the Party Started :: P!NK
Get Right :: Jennifer Lopez
Get Low (feat. Ying Yang Twins) :: Lil Jon & The East Side Boyz
Low (feat. T-Pain) :: Flo Rida
Get Low (Edit) :: Dillon Francis, DJ Snake
Get Free (feat. Amber Coffman) (feat. Amber Coffman) :: Major Lazer
Get Busy :: Sean Paul
Geronimo :: Sheppard
Genghis Khan :: Miike Snow
Gecko (Overdrive) [Extended Edit] :: Oliver Heldens, Becky Hill
GDFR (feat. Sage The Gemini & LooKas) :: Flo Rida
Gangnam Style :: PSY
Gassed Up :: Jauz, DJ Snake
Gasoline :: Halsey
Gasolina :: Daddy Yankee
Gamer Girl Love Song :: Tryhardninja
Game Over (feat. Giggs, Professor Green, Tinie Tempah & Devlin) :: Tinchy Stryder
Funkytown :: Lipps Inc.
Funk Like We Used To (Snareskin Remix) (feat. Snareskin) :: JeL
Funhouse :: P!NK
Fume à fond :: Lorenzo
fuck, i'm lonely (feat. Anne-Marie) :: Lauv
Fuck Your Money :: Elohim
Fuck You :: Lily Allen
Fuck You :: CeeLo Green
FRIENDS :: Marshmello, Anne-Marie
The Renegade (Radio Edit) :: Friend Within
Fresh Eyes :: Andy Grammer
Frequency :: Sylvan Esso
Freaky Me, Freaky You :: Cherub
Freaks (Radio Edit) :: Timmy Trumpet, Savage
Freak (Klaas Mix) :: Klaas, Bodybangers
Freak (feat. Kardinal Offishall) :: Estelle
Freak (feat. Cari Golden) :: CamelPhat
Frag Out :: DJ Assass1n
FourFiveSeconds :: Rihanna, Kanye West, Paul McCartney
Forget :: Patrick Topping
For The Girl :: The Fratellis
For the First Time :: The Script
For Elise :: Saint Motel
Flying Machine :: Everly
Fluorescent Adolescent :: Arctic Monkeys
Floating (feat. Khalid) :: Alina Baraz
Flash :: Green Velvet
Flamingo :: Kero Kero Bonito
Fix You :: Coldplay
Five More Hours :: Deorro, Chris Brown
Gedina - First Time, First Love (Lyric Video) Coca-Cola – Kiss Happiness :: MegaKlickTv
First Time :: Robin Beck
First of the Year (Equinox) :: Skrillex
Firefly (feat. Haley) :: Ramzoid
Fireflies :: Owl City
Fired Up (Remix) :: Armed Fitness
Fire Burning :: Sean Kingston
Fire :: Louis The Child, Evalyn
Final Song :: MØ
World Championship Finale 2 (From "Pitch Perfect 2" Soundtrack) :: The Barden Bellas
Fill My Little World :: The Feeling
Fidelity :: Regina Spektor
Feels :: Kiiara
feelings are fatal :: mxmtoon
Feeling Good :: Apashe, Cherry Lena
Feel the Love (feat. John Newman) :: Rudimental
Feel It Still :: Portugal. The Man
Feel Good Inc. :: Gorillaz, De La Soul
Feel :: Bombay Bicycle Club
Feed Your Head :: Paul Kalkbrenner
Father And Son :: Cat Stevens
Fashion Week :: veZk
Fantasy :: The xx
Fantasy :: Mariah Carey
Fancy Footwork :: Chromeo
Familiar :: Liam Payne, J Balvin
Faded :: ZHU
Faded :: Alan Walker
Fade :: Alan Walker
Fabulous :: Sharpay, Lucas Grabeel, Disney
Eyes Shut :: Olly Alexander (Years & Years)
Eyes on Fire (Zeds Dead Remix) :: Blue Foundation, Zeds Dead
Ex's & Oh's :: Elle King
Express Yourself :: Labrinth
Explicit :: Papa Ya
Everything You Wanted :: Kele
Everything Black (feat. Mike Taylor) :: Unlike Pluto
Everything at Once :: Lenka
Everyday (feat. Rod Stewart, Miguel & Mark Ronson) :: A$AP Rocky
【Mashup】 Everybody's Circulation - TMABird (Lyrics) :: Kyro
Everybody Talks :: Neon Trees
Everybody Knows :: Sigrid
Everybody in Love :: JLS
Everybody :: Ingrid Michaelson
Every Feeling :: Ezra Furman
Ever Fallen in Love :: Nouvelle Vague, Mélanie Pain
Eternal Flame (Single Version) :: Atomic Kitten
Ephemeral :: Bassnectar
Ends of the Earth :: Lord Huron
Empire State Of Mind (feat. Alicia Keys) :: JAY-Z
Elvis Ain't Dead :: Scouting For Girls
Elle me dit :: MIKA
Electric Love :: BØRNS
Electric Feel :: MGMT
Eat Sleep Rave Repeat (Calvin Harris Remix) (feat. Beardyman) :: Fatboy Slim
Easy Love :: Sigala
Easy (feat. Rafiq Bhatia) :: Son Lux
Earthquake (feat. Tinie Tempah) :: Labrinth
Earthquake (DJ Fresh vs. Diplo) (Edit) (feat. Dominique Young Unique) :: DJ Fresh, Diplo
Earned It (Fifty Shades Of Grey) [From The "Fifty Shades Of Grey" Soundtrack] :: The Weeknd
E.T. (feat. Kanye West) :: Katy Perry
E Samba (Junior Jack Original Club Mix) :: Junior Jack
E Samba (Radio Edit) :: Junior Jack
Dynamite :: Taio Cruz
Dynamite :: BTS
Dust Clears :: Clean Bandit
Dum Dee Dum :: Keys N Krates
Drummer Boy :: Alesha Dixon
Drop It Like It's Hot (feat. Pharrell Williams) :: Snoop Dogg
Homebound :: DROELOE
drivers license :: Olivia Rodrigo
Drive By :: Train
Drinkee (Radio Edit) :: SOFI TUKKER
Dreams :: Nuages
Cat Power - Dreams :: Fernando Massuyama
Dreamers :: TGC
Dream Girl :: Anna of the North
Dream Big- Upper West ft. Skizzy Mars :: Upper West
Dream :: Dizzee Rascal
Drama Club :: Melanie Martinez
Dragostea din tei :: O-Zone
Downtown (feat. Eric Nally, Grandmaster Caz, Kool Moe Dee & Melle Mel) :: Macklemore & Ryan Lewis
Down With The Trumpets :: Rizzle Kicks
Down The Road :: C2C
Down On Me (feat. 50 Cent) :: Jeremih
Down (feat. Lil Wayne) :: Jay Sean
Dorothy :: Polo & Pan
Dopamine Machine (Club Mix) :: CamelPhat, Ali Love
Don't Wanna Go Home :: Jason Derulo
Don’t Stop The Party :: The Black Eyed Peas
Don't Stop Movin' :: S Club
Don't Stop :: 5 Seconds of Summer
Don't Start Now :: Dua Lipa
Don't Mind :: Kent Jones
Don't Look Back In Anger :: Oasis
Don't Lie :: The Black Eyed Peas
Don't Know Why :: Norah Jones
Don't Fucking Tell Me What To Do :: Robyn
Don't Call Me Baby :: Madison Avenue
Dommage :: Bigflo & Oli
Dominos :: The Big Pink
Nightcore - Dollhouse :: NightcoreReality
Chitty Chitty Bang Bang 14 - Doll On A Music Box :: Tristan Edge
Dog Days Are Over :: Florence + The Machine
Do You? :: TroyBoi
Do Wah Diddy Diddy :: Manfred Mann
Do My Thing (feat. Philosofie) :: Lucian
Do It Right :: Anne-Marie
Elyar Fox - Do It All Over Again (Audio) :: shelb
Do It Again :: The Chemical Brothers
Do I Wanna Know? :: Arctic Monkeys
Disco Inferno :: 50 Cent
羊了个羊背景音 :: 洛天依 & 言和
Dirty Little Secret :: The All-American Rejects
Dip It Low :: Christina Milian
Digital Love :: Daft Punk
Diamond Rings (feat. Emeli Sandé) :: Chipmunk
Devi Prayer :: Craig Pruess & Ananda
Destination Calabria [Radio Edit] (feat. Crystal Waters) :: Alex Gaudino
Despacito :: Luis Fonsi, Daddy Yankee
Desert Adventure :: Captain Hook
Dernière danse :: Indila
Demons Of Pain (Remix) :: Infected Mushroom
Demons :: Imagine Dragons
Delicate :: Taylor Swift
Deep Jungle Walk :: Astrix
Deep into Nature :: Captain Hook
Dedication To My Ex (Miss That) (feat. André 3000 & Lil Wayne) :: Lloyd
Deceiver :: Chris Lake, Green Velvet
Dear God :: Confetti
Dear Future Husband :: Meghan Trainor
Days Without You (Crussen Remix) (feat. Miou Amadée) :: Satori (NL)
Daydream In Blue :: I Monster
Day 'N' Nite (US Mix) :: Kid Cudi, Crookers
Danza Kuduro (Version MTO) (feat. Don Omar) :: Lucenzo
LEFT BOY - Dangerous :: Emily Collins
Dangerous (feat. Sam Martin) :: David Guetta
Dangerous :: Big Data, Joywave
Dancing in the Moonlight :: Toploader
Dancing (Again!) (feat. Tiga, Audion & Ron Costa) :: Eats Everything
Dancin (Krono Remix) (feat. Luvli) :: Aaron Smith, Krono
Dancin' (I got the pills) - Erick Morillo :: EVILNIGHTZ
Dance With My Father :: Luther Vandross
Dance of the Sugar Plum Fairy :: Pentatonix
Dance Monkey :: Tones And I
Dance Machine :: Ben Sterling
Justice - DANCE (CRNKN Dubstep Remix) :: UNITEDubstep
Daisy :: Ashnikko
Crashed The Wedding :: Busted
Crave You (Adventure Club Remix) :: Flight Facilities
Crush On You :: Nero
Cry Me a River :: Justin Timberlake
Cry Me Out :: Pixie Lott
Cupid's Chokehold / Breakfast in America :: Gym Class Heroes
Cups (Pitch Perfect’s “When I’m Gone”) (Pop Version) :: Anna Kendrick
Crank That (Soulja Boy) :: Soulja Boy Tell'em
Count On Me :: Connie Talbot
Cotton Eye Joe :: Rednex
Cooler Than Me (Single Mix) :: Mike Posner
Cool Kids :: Echosmith
Convention Performance (From "Pitch Perfect 2" Soundtrack) :: The Barden Bellas
Congratulations (feat. Quavo) :: Post Malone
Confusion Girl (Shame Shame Shame) :: Frankmusik
Confessions Part II :: Usher
Coming Over (filous Remix) :: James Hersey
Come Go with Me (from "Set It Up") - Adam Bravin & Esthero :: トットちゃん
Come and Get Your Love (Single Version) :: Redbone
Come Along :: Cosmo Sheldrake
Come & Get It :: Krewella
Colors of the Wind :: Judy Kuhn
Cold Water (feat. Justin Bieber & MØ) :: Major Lazer
Cold Little Heart :: Michael Kiwanuka
Cold Cold Man :: Saint Motel
Cola Song (feat. J Balvin) :: Inna
Cola (Club Mix) :: CamelPhat, Elderbrook
Handsome Dancer - Coincidance :: Handsome Dancer
Zeds Dead - Coffee Break [HD] :: DANK MUSIC
Clumsy :: Fergie
Club Can't Handle Me (feat. David Guetta) [Sidney Samson Remix] (feat. David Guetta) :: Flo Rida
Club Can't Handle Me (feat. David Guetta) [From the Step Up 3D Soundtrack] (feat. David Guetta) :: Flo Rida
Closer (feat. Halsey) :: The Chainsmokers
Close Your Eyes :: Meghan Trainor
Climax :: Usher
Clear (Shawn Wasabi Remix) :: Pusher
Classic Man (feat. Roman GianArthur) :: Jidenna
Classic :: MKTO
Clair De Lune (remix) :: Will Borders
Clair De Lune Debussy Remix :: Direct To Dreams
Clair de Lune (Studio Version) :: Johann Debussy
Clair De Lune :: Claude Debussy
Circus :: Britney Spears
Cinema (Skrillex Remix) (feat. Gary Go) :: Benny Benassi
Church (feat. T-Pain) :: T-Pain
Chunky :: Format:B
Chocolate :: The 1975
Chillin (feat. Lady Gaga) :: Wale
Chill Bill (feat. J. Davi$ & Spooks) :: Rob $tone
Chica Bomb :: Dan Balan
Chelsea Hotel No 2 :: Lana Del Rey
Chelsea Dagger :: The Fratellis
Cheerleader (Felix Jaehn Remix) (Radio Edit) :: OMI
Check On It (feat. Bun B & Slim Thug) :: Beyoncé
Check It Out (Main Radio Mix) :: will.i.am, Nicki Minaj
Check It Out :: Oh The Larceny
chateau :: blackbear
Chasing Pavements :: Adele
Chasing Cars :: Snow Patrol
Champagne Supernova :: Oasis
Jibbs - Chain Hang Low (Crizzly & AFK Remix) :: realityDUBSTEP
C'est la Vie :: B*Witched
Carry Out (feat. Justin Timberlake) :: Timbaland
Carried Away :: Passion Pit
Carol of the Bells (From "Home Alone" Soundtrack) :: John Williams
carmen :: Stromae
Capricorn :: Elderbrook
CAN'T STOP THE FEELING! (from DreamWorks Animation's "TROLLS") :: Justin Timberlake
Sonny J : Can't Stop Moving : Download Now! :: SonnyJTV
Can't Stop :: Red Hot Chili Peppers
Can't Say No :: Conor Maynard
Can't Help Falling in Love :: Haley Reinhart
Can't Feel My Face :: The Weeknd
Can't Do Better :: Lucian
Can't Be Touched (feat. Mr. Magic & Trouble) :: Roy Jones Jr
Canon in D :: Kanon Orchestre de Chambre, Jean-Francois Paillard, & Johann Pachelbel
Candy Shop (feat. Olivia) :: 50 Cent
Candyman :: Christina Aguilera
Can-Can :: Johann Strauss Orchestra
Call You Back :: Josh Butler, Bontan
Call On Me (Ryan Riback Remix) :: Starley
Call Me Maybe :: Carly Rae Jepsen
Calabria 2007 (Radio Edit) (feat. Natasja) :: Enur
Cake By The Ocean :: DNCE
Ça ira :: Joyce Jonathan
Buzzin Remix (feat. 50 Cent) :: Mann
Buttons (Final Edit Version) (feat. Snoop Dogg) :: The Pussycat Dolls
Burn the House Down :: AJR
Bummin on Tremelo :: Kevin MacLeod
Bullit :: Watermät
Bulletproof :: La Roux
Bullet Train (feat. Joni Fatora) :: Stephen Swartz
Buggin' (Edit) :: Hot Since 82, Jem Cooke
Budapest :: George Ezra
Bubbly :: Colbie Caillat
Broken :: Lund
Broccoli (feat. Lil Yachty) :: Shelley FKA DRAM
Flower :: Moby
Bring It All Back :: S Club
BAKERMAT- BRIGHTERS DAYS (Bootleg) Free Download :: Salza-at-Night
Trebles Finals: Bright Lights Bigger City/Magic :: The Treblemakers
Bridge Over Troubled Water (with The Royal Philharmonic Orchestra) :: Elvis Presley, The Royal Philharmonic Orchestra
Breezeblocks :: alt-J
Breathe Deeper :: Tame Impala
Breathe (Rap Version) (feat. Sean Paul) :: Blu Cantrell
Breathe (feat. Ina Wroldsen) :: Jax Jones
Breathe (feat. Jem Cooke) :: CamelPhat, Cristoph
Breakn' a Sweat :: Skrillex, The Doors
Breakeven :: The Script
Break the Rules :: Charli xcx
Brave :: Sara Bareilles
Boys And Girls :: Pixie Lott
Boyfriend :: Justin Bieber
Diplo ft. GTA - Boy oh Boy :: Axel Abrahamsson
7kingZ - "'Bout To Get Real" [AUDIO] :: 7kingZ
Jocelyn Alice - Bound to You (Pluto Remix) :: MrSuicideSheep
Bounce (feat. Dr. Dre) :: Timbaland, Missy Elliott, Justin Timberlake
Bounce (Radio Edit) (feat. Kelis) :: Calvin Harris
Boulevard of Broken Dreams :: Green Day
Bottoms Up (feat. Nicki Minaj) :: Trey Songz
Boss Mode :: Knife Party
Booyah (feat. We Are Loud & Sonny Wilson) :: Showtek
Booty Swing :: Parov Stelar
Boom, Boom, Boom, Boom!! :: Vengaboys
Move, Shake, Drop :: DJ Laz, Flo Rida, & Casely
Boom Clap :: Charli xcx
Boom Boom Pow :: The Black Eyed Peas
BOOM (Extended Mix) :: Tiësto, Sevenn
Nightcore  - Bonjour Madame (Remix) ✕ :: NightcoreLounge
Bonita :: J Balvin, Jowell & Randy
Eyes on Fire :: Blue Foundation
Bomb A Drop :: Garmiani
Bom Bom (Radio Edit) :: Sam And The Womp
Body Talk :: Just Kiddin
BO$$ :: Fifth Harmony
Blue Monday :: New Order
Blow :: Kesha
Blood Sugar :: Pendulum
Blood In The Cut :: K.Flay
Blind Faith (feat. Liam Bailey) :: Chase & Status
Blew My Mind :: Dresses
Blah Blah Blah :: Armin van Buuren
Blackout :: Breathe Carolina
Black Widow (feat. Rita Ora) :: Iggy Azalea
Black Skinhead :: Kanye West
Black Sheep (Brie Larson Vocal Version) (feat. Brie Larson) :: Metric
Black Mirror :: Sophie Simmons
Black Heart :: Stooshe
Hey Mama :: The Black Eyed Peas
Black Car :: Miriam Bryant
Black Beatles (feat. Gucci Mane) :: Rae Sremmurd
Black and Yellow :: Wiz Khalifa
Bla Bla Bla :: Gigi D'Agostino
Birthday Sex :: Jeremih
Bills :: LunchMoney Lewis
Billionaire (feat. Bruno Mars) :: Travie McCoy
Big When I Was Little :: Eliza Doolittle
Big Time :: Ben Klock
Big in Japan (feat. Idoling!!!) :: Martin Solveig, Dragonette
Big Girls Don't Cry (Personal) :: Fergie
Big Dater :: Big Data
Big :: Lemaitre
Betty Boop (Electro Swing) :: Betty Booom
Better When I'm Dancin' :: Meghan Trainor
Better Together :: Jack Johnson
Better (feat. Roxanna) :: Valentino Khan, Wuki
Best Friend (feat. NERVO, The Knocks & ALISA UENO) :: SOFI TUKKER
Best Day Of My Life :: American Authors
Berzerk :: Eminem
Beneath Your Beautiful (feat. Emeli Sandé) :: Labrinth
Bella Ciao :: El Profesor
Bella :: GIMS
Beggin (original version) :: Madcon
Before Midnight Tonight :: Hugo Kant
Beep (feat. will.i.am) :: The Pussycat Dolls
BedRock (feat. Lloyd) :: Young Money
Beautiful Ones :: Suede
Beautiful Lies VIP :: B-Complex
Beautiful Girls :: Sean Kingston
Beautiful :: Christina Aguilera
Be Together (feat. Wild Belle) :: Major Lazer
Be Sharp Say Nowt :: Patrick Topping
Be OK :: Ingrid Michaelson
Be Like You (feat. Broods) :: Whethan
Be Alright :: Dean Lewis
Bassline Junkie (Bonus Track) :: Dizzee Rascal
Bass Inside :: AC Slater
Bass Down Low (feat. The Cataracs) :: DEV
The Bare Necessities :: Phil Harris, Bruce Reitherman
Barcelona :: George Ezra
Barbie Girl :: Aqua
Bap U :: Party Favor
Bangarang (feat. Sirah) :: Skrillex
Bang Bang Bang (feat. MNDR) :: Mark Ronson, The Business Intl.
Bang Bang :: will.i.am
Bang Bang :: Ariana Grande, Nicki Minaj, Jessie J
Banana Pancakes :: Jack Johnson
Banana Brain :: Die Antwoord
Bad Things :: mgk, Camila Cabello
Bad Romance :: Lady Gaga
Bad Karma :: Axel Thesleff
bad guy :: Billie Eilish
Bad Girls :: M.I.A.
Bad Decisions (Purple Disco Machine Remix) :: Two Door Cinema Club
Bad Day :: Daniel Powter
Bad :: Oski, Anuka
Bad [Radio Edit] (feat. Vassy) :: David Guetta, Showtek
Bad :: Lennon Stella
Back to You (feat. Bebe Rexha & Digital Farm Animals) :: Louis Tomlinson
Back To Black :: Amy Winehouse
Back in Time (featured in "Men In Black 3") :: Pitbull
Baby (feat. Ludacris) :: Justin Bieber
¡Ay doctor! :: Jesse & Joy
Ave Maria, Op. 52 No. 6, D. 839 (feat. Geoffrey Parsons) :: Barbara Bonney, Franz Schubert
Autobronzant :: Corina
Attrape-rêve :: Polo & Pan
Attracting Flies :: AlunaGeorge
At the River :: Groove Armada
At The Door :: The Strokes
At Least It Was Here ("Community" Main Title) [Full Length Version] :: The 88
Ass-n-Titties :: DJ Assault
Asgard :: Bertzi
Around The World (feat. Fetty Wap) :: Natalie La Rose
Around the World (La La La La La) :: A Touch of Class
April Showers :: ProleteR
Apricots :: Bicep
Applause :: Lady Gaga
Apologize (feat. OneRepublic) :: Timbaland
Anywhere :: Rita Ora
Anything Could Happen :: Ellie Goulding
anxiety :: blackbear
Antidote (Radio Edit) :: Swedish House Mafia, Knife Party
Animal Spirits :: Vulfpeck
Animal :: Miike Snow
Angel Of The Morning :: Juice Newton
Angel In The Night :: Basshunter
Android Porn :: Kraddy
American Pie :: Don McLean
American Idiot :: Green Day
Amazing (feat. Young Jeezy) :: Kanye West
Amazing (Radio Edit) :: Inna
Am I Wrong :: Nico & Vinz
Look On The Bright Side Of Life (All Things Dull And Ugly) :: Monty Python
Alors On Danse (DubDogz Extended Remix) :: Stromae
Alors on danse (Radio Edit) :: Stromae
Along Came Polly :: Rebuke
Alone in Kyoto :: Air
Alone :: Alan Walker
All These Things That I've Done :: The Killers
All The Things She Said :: t.A.T.u.
All The Small Things :: blink-182
All Star, but it's so Beautiful... (Piano Version) :: Toms Mucenieks
All Star :: Smash Mouth
All Rise :: YONAS
All Of The Lights :: Kanye West
All Night :: Parov Stelar
All Night (feat. Knox Fortune) :: Chance the Rapper
All Night :: Big Boi
All My Friends (feat. Snakehips) :: Snakehips
All I Want is You :: Barry Louis Polisar
All I Want :: Kodaline
All I Got :: Hendersin
All I Ever Wanted (Radio Edit) :: Basshunter
All I Do Is Win (feat. T-Pain, Ludacris, Snoop Dogg & Rick Ross) :: DJ Khaled
All I Do Is Dream of You (feat. dodie) :: Faultline
All Fired Up :: The Saturdays
All 'Cause of You :: The 88
All About You :: McFly
All About That Bass :: Meghan Trainor
Alive (Stephen Swartz Remix) :: Krewella
Alice :: Pogo
Airplanes (feat. Hayley Williams of Paramore) :: B.o.B
Air Balloon :: Lily Allen
Ain't No Mountain High Enough :: Marvin Gaye, Tammi Terrell
Ain't My Fault :: Zara Larsson
Afterglow :: Wilkinson, Becky Hill
After the Afterparty (feat. Lil Yachty) :: Charli xcx
After Dark :: Mr.Kitty
Adore You :: Miley Cyrus
Addicted to Bass :: Puretone
ADD (feat. Emilia Ali) :: dwilly
Acid Rain :: Alpha Portal
Acapella :: Kelis
About You Now :: Sugababes
About You Now :: Meadowlark
ABC :: Jackson 5
A Thousand Years (Radio Edit) :: christina perri
A Thousand Miles :: Vanessa Carlton
A Night Like This :: Caro Emerald
A Milli :: Lil Wayne
A Dream Is a Wish Your Heart Makes :: Lily James
9TS (90s Baby) :: Redlight
99 New Soul Problems (Newcomers Mashup) :: Lyna Nguyen
99 Luftballons :: Nena
9 to 5 :: Dolly Parton
7 rings :: Ariana Grande
5 Years Time :: Noah And The Whale
5 O'Clock (feat. Lily Allen & Wiz Khalifa) :: T-Pain
4u :: blackbear
4000Hz :: Jaded
4 My People (Basement Jaxx Remix) [Radio Edit] (Basement Jaxx Remix; Radio Edit) :: Missy Elliott
3 Nights :: Dominic Fike
3 Foot Tall :: Classified
3 :: Britney Spears
212 :: Azealia Banks
2012 (It Ain't The End) (feat. Nicki Minaj) :: Jay Sean
2002 :: Anne-Marie
1985 :: Bowling For Soup
1901 :: Phoenix
Daft Punk vs. Gorillaz - "19-2000 Funk" :: Icarus1234566
19-2000 (Soulchild Remix) :: Gorillaz
19-2000 :: Gorillaz, Miho Hatori, & Tina Weymouth
1234 :: Feist
10 Victoria's Secret Models :: MAX
1, 2 Step (feat. Missy Elliott) :: Ciara
#SELFIE :: The Chainsmokers